日期,商品名稱,買賣權別,身份別,買方交易口數,買方交易契約金額(千元),賣方交易口數,賣方交易契約金額(千元),交易口數買賣淨額,交易契約金額買賣淨額(千元),買方未平倉口數,買方未平倉契約金額(千元),賣方未平倉口數,賣方未平倉契約金額(千元),未平倉口數買賣淨額,未平倉契約金額買賣淨額(千元)
2015/4/23,臺指選擇權,CALL,自營商,433676,1391657,448091,1441798,-14415,-50141,92669,581751,137980,1229085,-45311,-647334
2015/4/23,臺指選擇權,CALL,投信,150,525,0,0,150,525,200,670,450,3998,-250,-3328
2015/4/23,臺指選擇權,CALL,外資及陸資,100570,376757,83182,412593,17388,-35836,266299,1965293,40201,467033,226098,1498260
2015/4/23,臺指選擇權,PUT,自營商,372591,669228,371050,709332,1541,-40104,162231,230243,147288,344877,14943,-114634
2015/4/23,臺指選擇權,PUT,投信,0,0,0,0,0,0,329,137,0,0,329,137
2015/4/23,臺指選擇權,PUT,外資及陸資,49544,170576,41873,131094,7671,39481,223572,479662,52350,141697,171222,337965
2015/4/24,臺指選擇權,CALL,自營商,325271,1279767,350855,1503690,-25584,-223923,107120,810880,177841,1750886,-70721,-940006
2015/4/24,臺指選擇權,CALL,投信,112,441,62,391,50,51,250,1058,450,5580,-200,-4522
2015/4/24,臺指選擇權,CALL,外資及陸資,95337,438931,97527,634120,-2190,-195189,272074,2505211,48008,639119,224066,1866092
2015/4/24,臺指選擇權,PUT,自營商,301576,757902,319688,748253,-18112,9649,177696,333018,181010,412869,-3314,-79851
2015/4/24,臺指選擇權,PUT,投信,10,35,0,0,10,35,339,132,0,0,339,132
2015/4/24,臺指選擇權,PUT,外資及陸資,54803,201437,55272,212335,-469,-10898,228547,517292,57879,186967,170668,330325
2015/4/27,臺指選擇權,CALL,自營商,246397,874798,257280,964827,-10883,-90029,113129,1049165,194865,2282935,-81736,-1233770
2015/4/27,臺指選擇權,CALL,投信,0,0,100,511,-100,-511,200,1220,500,7578,-300,-6358
2015/4/27,臺指選擇權,CALL,外資及陸資,79086,327411,77815,428552,1271,-101140,280417,3167911,55102,854014,225315,2313897
2015/4/27,臺指選擇權,PUT,自營商,208692,461272,233567,444422,-24875,16850,198332,350360,226588,400827,-28256,-50467
2015/4/27,臺指選擇權,PUT,投信,0,0,0,0,0,0,339,66,0,0,339,66
2015/4/27,臺指選擇權,PUT,外資及陸資,38816,151790,40239,174169,-1423,-22379,234440,503140,65214,222441,169226,280699
2015/4/28,臺指選擇權,CALL,自營商,168766,396228,175982,429640,-7216,-33412,120301,909078,209576,2074438,-89275,-1165360
2015/4/28,臺指選擇權,CALL,投信,50,102,50,90,0,12,250,1046,550,6870,-300,-5824
2015/4/28,臺指選擇權,CALL,外資及陸資,30160,123126,33858,169856,-3698,-46731,283621,2848973,62034,819507,221587,2029466
2015/4/28,臺指選擇權,PUT,自營商,189163,301373,207874,288545,-18711,12828,202236,396320,249282,436277,-47046,-39957
2015/4/28,臺指選擇權,PUT,投信,10,21,0,0,10,21,349,74,0,0,349,74
2015/4/28,臺指選擇權,PUT,外資及陸資,29467,70287,21727,71222,7740,-935,245631,502927,68668,233175,176963,269752
2015/4/29,臺指選擇權,CALL,自營商,325055,643426,338912,630862,-13857,12564,78119,506807,149068,1373254,-70949,-866447
2015/4/29,臺指選擇權,CALL,投信,50,128,300,660,-250,-532,250,640,600,3249,-350,-2609
2015/4/29,臺指選擇權,CALL,外資及陸資,38165,121689,36895,132282,1270,-10593,279025,2196627,63276,644459,215749,1552168
2015/4/29,臺指選擇權,PUT,自營商,361479,701086,359871,607264,1608,93821,137142,425480,163928,417443,-26786,8037
2015/4/29,臺指選擇權,PUT,投信,300,774,0,0,300,774,349,877,0,0,349,877
2015/4/29,臺指選擇權,PUT,外資及陸資,38308,111230,34482,114187,3826,-2957,248117,545878,66836,265483,181281,280395
2015/4/30,臺指選擇權,CALL,自營商,177974,395768,179979,413933,-2005,-18165,93704,477084,166865,1297099,-73161,-820015
2015/4/30,臺指選擇權,CALL,投信,0,0,0,0,0,0,250,538,600,2740,-350,-2202
2015/4/30,臺指選擇權,CALL,外資及陸資,23740,93174,30433,116925,-6693,-23751,276858,2018909,67763,604533,209095,1414376
2015/4/30,臺指選擇權,PUT,自營商,173690,373924,164246,363113,9444,10811,158017,489900,175525,467120,-17508,22780
2015/4/30,臺指選擇權,PUT,投信,29,377,29,44,0,334,349,1285,0,0,349,1285
2015/4/30,臺指選擇權,PUT,外資及陸資,28371,101396,24458,94757,3913,6639,255077,584538,69861,290024,185216,294514
2015/5/4,臺指選擇權,CALL,自營商,187813,342733,193365,391784,-5552,-49051,99784,459802,178548,1302624,-78764,-842822
2015/5/4,臺指選擇權,CALL,投信,0,0,0,0,0,0,250,460,600,2494,-350,-2034
2015/5/4,臺指選擇權,CALL,外資及陸資,22220,74327,21316,77037,904,-2710,279642,1967038,69707,598765,209935,1368273
2015/5/4,臺指選擇權,PUT,自營商,199455,350163,182339,328406,17116,21757,185790,462635,186220,433391,-430,29244
2015/5/4,臺指選擇權,PUT,投信,0,0,0,0,0,0,349,975,0,0,349,975
2015/5/4,臺指選擇權,PUT,外資及陸資,26479,73305,18372,67509,8107,5796,265108,529044,71771,268485,193337,260559
2015/5/5,臺指選擇權,CALL,自營商,183286,284469,184414,290860,-1128,-6391,99987,397229,180000,1155304,-80013,-758075
2015/5/5,臺指選擇權,CALL,投信,0,0,0,0,0,0,250,305,600,1932,-350,-1627
2015/5/5,臺指選擇權,CALL,外資及陸資,29253,78867,28302,78511,951,356,280774,1738797,69850,527836,210924,1210961
2015/5/5,臺指選擇權,PUT,自營商,177742,317173,177029,318276,713,-1104,192496,500055,192261,472040,235,28015
2015/5/5,臺指選擇權,PUT,投信,0,0,0,0,0,0,349,1147,0,0,349,1147
2015/5/5,臺指選擇權,PUT,外資及陸資,25486,87253,23571,80631,1915,6622,267445,562031,72205,287493,195240,274538
2015/5/6,臺指選擇權,CALL,自營商,257425,386470,272721,383345,-15296,3125,72793,386566,159266,1126057,-86473,-739491
2015/5/6,臺指選擇權,CALL,投信,0,0,300,568,-300,-568,250,265,600,2437,-350,-2172
2015/5/6,臺指選擇權,CALL,外資及陸資,27420,77173,23691,72154,3729,5018,277830,1706774,67593,517674,210237,1189100
2015/5/6,臺指選擇權,PUT,自營商,242585,387035,256626,407456,-14041,-20422,146276,467941,179314,436877,-33038,31064
2015/5/6,臺指選擇權,PUT,投信,300,738,0,0,300,738,349,1148,0,0,349,1148
2015/5/6,臺指選擇權,PUT,外資及陸資,27886,92764,23444,80976,4442,11789,268457,554286,69551,276470,198906,277816
2015/5/7,臺指選擇權,CALL,自營商,170630,311973,171479,320431,-849,-8458,82090,303604,169501,920892,-87411,-617288
2015/5/7,臺指選擇權,CALL,投信,0,0,0,0,0,0,250,104,600,1317,-350,-1213
2015/5/7,臺指選擇權,CALL,外資及陸資,32147,93160,30089,87234,2058,5927,286308,1366044,74028,416914,212280,949130
2015/5/7,臺指選擇權,PUT,自營商,166246,345202,158844,372968,7402,-27766,156671,623406,182369,579421,-25698,43985
2015/5/7,臺指選擇權,PUT,投信,0,0,0,0,0,0,349,2022,0,0,349,2022
2015/5/7,臺指選擇權,PUT,外資及陸資,33854,120969,23317,101708,10537,19261,281008,734568,71499,363387,209509,371181
2015/5/8,臺指選擇權,CALL,自營商,155589,223029,146624,223953,8965,-924,100049,278154,178900,846399,-78851,-568245
2015/5/8,臺指選擇權,CALL,投信,0,0,0,0,0,0,250,60,600,949,-350,-889
2015/5/8,臺指選擇權,CALL,外資及陸資,22241,56066,23818,70316,-1577,-14251,291900,1249253,81219,389944,210681,859309
2015/5/8,臺指選擇權,PUT,自營商,147549,224660,142161,245833,5388,-21173,162913,662571,183287,633578,-20374,28993
2015/5/8,臺指選擇權,PUT,投信,0,0,0,0,0,0,349,2287,0,0,349,2287
2015/5/8,臺指選擇權,PUT,外資及陸資,17996,53837,22241,62854,-4245,-9017,281093,774210,75766,396231,205327,377979
2015/5/11,臺指選擇權,CALL,自營商,247212,415857,264286,430892,-17074,-15035,93825,267849,189726,832973,-95901,-565124
2015/5/11,臺指選擇權,CALL,投信,0,0,0,0,0,0,250,56,600,882,-350,-826
2015/5/11,臺指選擇權,CALL,外資及陸資,27499,85454,31990,97365,-4491,-11911,293263,1229488,87068,394530,206195,834958
2015/5/11,臺指選擇權,PUT,自營商,250984,479998,239214,463624,11770,16373,178000,647010,186368,600385,-8368,46625
2015/5/11,臺指選擇權,PUT,投信,0,0,0,0,0,0,349,2201,0,0,349,2201
2015/5/11,臺指選擇權,PUT,外資及陸資,35261,128974,30904,114066,4357,14908,287871,754222,78143,385562,209728,368660
2015/5/12,臺指選擇權,CALL,自營商,190219,309397,205128,320853,-14909,-11456,98577,284511,209506,845295,-110929,-560784
2015/5/12,臺指選擇權,CALL,投信,0,0,0,0,0,0,250,47,600,755,-350,-708
2015/5/12,臺指選擇權,CALL,外資及陸資,17826,49877,23401,52179,-5575,-2302,290737,1183110,90130,378462,200607,804648
2015/5/12,臺指選擇權,PUT,自營商,203266,326138,209001,341274,-5735,-15136,176068,664061,189810,625294,-13742,38767
2015/5/12,臺指選擇權,PUT,投信,0,0,0,0,0,0,349,2341,0,0,349,2341
2015/5/12,臺指選擇權,PUT,外資及陸資,30352,70458,23874,76182,6478,-5724,296474,795334,80324,412463,216150,382871
2015/5/13,臺指選擇權,CALL,自營商,261913,464042,259033,434350,2880,29692,81079,295932,181183,863535,-100104,-567603
2015/5/13,臺指選擇權,CALL,投信,0,0,300,554,-300,-554,250,27,600,1355,-350,-1328
2015/5/13,臺指選擇權,CALL,外資及陸資,32839,93151,27578,89323,5261,3828,286274,1226229,88352,399018,197922,827211
2015/5/13,臺指選擇權,PUT,自營商,229312,333310,249798,360674,-20486,-27364,126656,548941,180075,529401,-53419,19540
2015/5/13,臺指選擇權,PUT,投信,300,635,0,0,300,635,349,1157,0,0,349,1157
2015/5/13,臺指選擇權,PUT,外資及陸資,26692,62704,23145,68273,3547,-5570,295458,697861,80926,369153,214532,328708
2015/5/14,臺指選擇權,CALL,自營商,249746,386446,277955,437389,-28209,-50943,80923,201064,209269,683051,-128346,-481987
2015/5/14,臺指選擇權,CALL,投信,0,0,0,0,0,0,250,10,600,317,-350,-307
2015/5/14,臺指選擇權,CALL,外資及陸資,28588,95130,25720,81384,2868,13746,293156,927226,92350,279042,200806,648184
2015/5/14,臺指選擇權,PUT,自營商,274538,511301,236724,494256,37814,17045,146159,852193,161874,735797,-15715,116396
2015/5/14,臺指選擇權,PUT,投信,0,0,0,0,0,0,349,2484,0,0,349,2484
2015/5/14,臺指選擇權,PUT,外資及陸資,34792,152341,26741,138402,8051,13939,306323,1089242,83718,588090,222605,501152
2015/5/15,臺指選擇權,CALL,自營商,237429,338130,240438,353723,-3009,-15594,90363,196587,221740,659063,-131377,-462476
2015/5/15,臺指選擇權,CALL,投信,0,0,0,0,0,0,250,7,600,142,-350,-135
2015/5/15,臺指選擇權,CALL,外資及陸資,35835,103230,35384,78846,451,24385,297632,908997,96370,262163,201262,646834
2015/5/15,臺指選擇權,PUT,自營商,229353,472135,221571,545215,7782,-73081,149667,862036,157770,807363,-8103,54673
2015/5/15,臺指選擇權,PUT,投信,0,0,0,0,0,0,349,2840,0,0,349,2840
2015/5/15,臺指選擇權,PUT,外資及陸資,31750,151764,31934,129547,-184,22217,305545,1181850,83047,623961,222498,557889
2015/5/18,臺指選擇權,CALL,自營商,153908,200640,166279,217532,-12371,-16892,92453,205267,236202,696618,-143749,-491351
2015/5/18,臺指選擇權,CALL,投信,0,0,0,0,0,0,250,5,600,104,-350,-99
2015/5/18,臺指選擇權,CALL,外資及陸資,45251,68811,49218,66370,-3967,2442,316234,949105,118948,277955,197286,671150
2015/5/18,臺指選擇權,PUT,自營商,124969,230902,121530,253337,3439,-22435,153280,779793,157966,763206,-4686,16587
2015/5/18,臺指選擇權,PUT,投信,0,0,0,0,0,0,349,2353,0,0,349,2353
2015/5/18,臺指選擇權,PUT,外資及陸資,17928,82403,19879,80165,-1951,2237,304240,1064306,83674,575741,220566,488565
2015/5/19,臺指選擇權,CALL,自營商,327211,622757,316958,579155,10253,43602,100140,315738,233636,856992,-133496,-541254
2015/5/19,臺指選擇權,CALL,投信,0,0,0,0,0,0,250,4,600,331,-350,-327
2015/5/19,臺指選擇權,CALL,外資及陸資,39532,117106,42024,123263,-2492,-6157,324167,1211146,129349,401422,194818,809724
2015/5/19,臺指選擇權,PUT,自營商,254094,373182,282650,396822,-28556,-23640,141860,575857,175119,600081,-33259,-24224
2015/5/19,臺指選擇權,PUT,投信,0,0,20,85,-20,-85,329,877,0,0,329,877
2015/5/19,臺指選擇權,PUT,外資及陸資,24858,93963,24998,65653,-140,28310,309931,840373,89526,443698,220405,396675
2015/5/20,臺指選擇權,CALL,自營商,224730,330545,249718,414563,-24988,-84018,47799,175944,110621,727017,-62822,-551073
2015/5/20,臺指選擇權,CALL,投信,0,0,498,1436,-498,-1436,0,0,498,1481,-498,-1481
2015/5/20,臺指選擇權,CALL,外資及陸資,27289,72837,23906,69812,3383,3025,216660,1082821,92906,329076,123754,753745
2015/5/20,臺指選擇權,PUT,自營商,229133,308211,231156,282617,-2023,25594,81586,330796,70869,347669,10717,-16873
2015/5/20,臺指選擇權,PUT,投信,300,772,0,0,300,772,329,1257,0,0,329,1257
2015/5/20,臺指選擇權,PUT,外資及陸資,33216,65478,19442,54169,13774,11310,179357,757252,59706,371303,119651,385949
2015/5/21,臺指選擇權,CALL,自營商,188806,377505,189218,404058,-412,-26553,72378,167055,135588,621422,-63210,-454367
2015/5/21,臺指選擇權,CALL,投信,0,0,0,0,0,0,0,0,498,567,-498,-567
2015/5/21,臺指選擇權,CALL,外資及陸資,40141,126664,37354,125103,2787,1560,224358,836038,97797,248591,126561,587447
2015/5/21,臺指選擇權,PUT,自營商,179878,505517,165323,520833,14555,-15316,107555,512620,82293,494821,25262,17799
2015/5/21,臺指選擇權,PUT,投信,0,0,0,0,0,0,329,2489,0,0,329,2489
2015/5/21,臺指選擇權,PUT,外資及陸資,44330,202237,41016,191265,3314,10971,185767,1039092,62812,514432,122955,524660
2015/5/22,臺指選擇權,CALL,自營商,177466,343308,155473,334551,21993,8757,96459,208729,137642,704020,-41183,-495291
2015/5/22,臺指選擇權,CALL,投信,100,203,200,306,-100,-104,100,198,698,1003,-598,-805
2015/5/22,臺指選擇權,CALL,外資及陸資,36578,131041,25548,95034,11030,36007,230862,923398,93265,263194,137597,660204
2015/5/22,臺指選擇權,PUT,自營商,171935,286605,162529,317895,9406,-31290,121966,379032,87263,424448,34703,-45416
2015/5/22,臺指選擇權,PUT,投信,0,0,0,0,0,0,329,1248,0,0,329,1248
2015/5/22,臺指選擇權,PUT,外資及陸資,27706,93720,22383,78435,5323,15284,193028,853175,64729,418195,128299,434980
2015/5/25,臺指選擇權,CALL,自營商,154621,293509,164307,281486,-9686,12023,97632,222430,148685,703471,-51053,-481041
2015/5/25,臺指選擇權,CALL,投信,0,0,0,0,0,0,100,185,698,909,-598,-724
2015/5/25,臺指選擇權,CALL,外資及陸資,20985,58875,21749,60398,-764,-1523,234322,912829,97547,263861,136775,648968
2015/5/25,臺指選擇權,PUT,自營商,143616,253944,140161,234184,3455,19759,129637,372876,91555,408251,38082,-35375
2015/5/25,臺指選擇權,PUT,投信,0,0,0,0,0,0,329,1083,0,0,329,1083
2015/5/25,臺指選擇權,PUT,外資及陸資,22518,47991,17185,52337,5333,-4346,200518,816350,66842,407424,133676,408926
2015/5/26,臺指選擇權,CALL,自營商,221589,395254,211970,402251,9619,-6997,112360,252271,153794,763972,-41434,-511701
2015/5/26,臺指選擇權,CALL,投信,0,0,0,0,0,0,100,216,698,979,-598,-763
2015/5/26,臺指選擇權,CALL,外資及陸資,34759,111734,34495,108983,264,2751,236426,964111,99387,284582,137039,679529
2015/5/26,臺指選擇權,PUT,自營商,208050,327895,215411,326218,-7361,1677,136305,357135,105584,406976,30721,-49841
2015/5/26,臺指選擇權,PUT,投信,0,0,0,0,0,0,329,804,0,0,329,804
2015/5/26,臺指選擇權,PUT,外資及陸資,29044,81324,29029,77959,15,3365,204383,774081,70692,388169,133691,385912
2015/5/27,臺指選擇權,CALL,自營商,222253,398129,216270,409204,5983,-11075,71110,235649,132807,707686,-61697,-472037
2015/5/27,臺指選擇權,CALL,投信,0,0,300,511,-300,-511,100,216,700,1370,-600,-1154
2015/5/27,臺指選擇權,CALL,外資及陸資,28965,88742,26542,85714,2423,3028,229211,953290,98811,287145,130400,666145
2015/5/27,臺指選擇權,PUT,自營商,199006,301453,231951,317688,-32945,-16235,99443,362891,101167,424745,-1724,-61854
2015/5/27,臺指選擇權,PUT,投信,300,819,0,0,300,819,329,1386,0,0,329,1386
2015/5/27,臺指選擇權,PUT,外資及陸資,28920,70952,24186,75541,4734,-4589,203438,783364,68393,391363,135045,392001
2015/5/28,臺指選擇權,CALL,自營商,136403,307401,136399,330487,4,-23086,81817,286638,143473,822100,-61656,-535462
2015/5/28,臺指選擇權,CALL,投信,0,0,30,117,-30,-117,70,163,700,1928,-630,-1765
2015/5/28,臺指選擇權,CALL,外資及陸資,24760,84910,25120,90010,-360,-5099,230252,1062736,100194,331449,130058,731287
2015/5/28,臺指選擇權,PUT,自營商,143348,252138,121681,249007,21667,3131,131030,326345,111092,390008,19938,-63663
2015/5/28,臺指選擇權,PUT,投信,0,0,0,0,0,0,329,786,0,0,329,786
2015/5/28,臺指選擇權,PUT,外資及陸資,22697,62943,20897,63091,1800,-149,208967,669551,72114,333867,136853,335684
2015/5/29,臺指選擇權,CALL,自營商,164632,310874,160777,346995,3855,-36121,106245,275689,164107,828032,-57862,-552343
2015/5/29,臺指選擇權,CALL,投信,0,0,0,0,0,0,70,145,700,1610,-630,-1465
2015/5/29,臺指選擇權,CALL,外資及陸資,21303,85711,19066,65976,2237,19735,235941,1048764,103663,323710,132278,725054
2015/5/29,臺指選擇權,PUT,自營商,156232,298770,140316,283820,15916,14950,154285,390956,117972,437479,36313,-46523
2015/5/29,臺指選擇權,PUT,投信,0,0,0,0,0,0,329,824,0,0,329,824
2015/5/29,臺指選擇權,PUT,外資及陸資,24231,74633,15414,52919,8817,21713,219861,734756,74163,360646,145698,374110
2015/6/1,臺指選擇權,CALL,自營商,178129,342345,211109,387018,-32980,-44673,106590,222992,197433,731500,-90843,-508508
2015/6/1,臺指選擇權,CALL,投信,30,50,0,0,30,50,100,125,700,879,-600,-754
2015/6/1,臺指選擇權,CALL,外資及陸資,30353,90043,32803,104734,-2450,-14691,240809,903070,110970,283178,129839,619892
2015/6/1,臺指選擇權,PUT,自營商,189162,429640,170266,381750,18896,47890,176592,539640,121495,538331,55097,1309
2015/6/1,臺指選擇權,PUT,投信,0,0,0,0,0,0,329,1265,0,0,329,1265
2015/6/1,臺指選擇權,PUT,外資及陸資,38842,131146,34025,126396,4817,4750,226172,854434,75718,429568,150454,424866
2015/6/2,臺指選擇權,CALL,自營商,170352,281190,165659,252735,4693,28455,111837,217131,197859,651614,-86022,-434483
2015/6/2,臺指選擇權,CALL,投信,0,0,0,0,0,0,100,83,700,587,-600,-504
2015/6/2,臺指選擇權,CALL,外資及陸資,27748,72215,25063,78315,2685,-6101,245420,835410,112898,263501,132522,571909
2015/6/2,臺指選擇權,PUT,自營商,145294,289558,157438,299627,-12144,-10068,170868,555331,127746,564645,43122,-9314
2015/6/2,臺指選擇權,PUT,投信,0,0,0,0,0,0,329,1277,0,0,329,1277
2015/6/2,臺指選擇權,PUT,外資及陸資,23694,72853,25188,80114,-1494,-7261,224491,885654,75572,451463,148919,434191
2015/6/3,臺指選擇權,CALL,自營商,202953,276699,237314,331664,-34361,-54965,72289,170036,176187,586892,-103898,-416856
2015/6/3,臺指選擇權,CALL,投信,1,2,301,679,-300,-677,100,44,700,1030,-600,-986
2015/6/3,臺指選擇權,CALL,外資及陸資,29592,76628,28406,83190,1186,-6563,242267,730869,112257,218858,130010,512011
2015/6/3,臺指選擇權,PUT,自營商,185562,333308,176842,316012,8720,17296,122291,554404,108618,525064,13673,29340
2015/6/3,臺指選擇權,PUT,投信,300,602,0,0,300,602,329,1279,0,0,329,1279
2015/6/3,臺指選擇權,PUT,外資及陸資,28018,84461,24144,83444,3874,1017,215891,967782,72812,499653,143079,468129
2015/6/4,臺指選擇權,CALL,自營商,297983,456876,331217,502797,-33234,-45921,91867,133034,229044,444777,-137177,-311743
2015/6/4,臺指選擇權,CALL,投信,0,0,0,0,0,0,100,10,700,173,-600,-163
2015/6/4,臺指選擇權,CALL,外資及陸資,43535,119816,45931,132737,-2396,-12920,247786,489247,120148,135506,127638,353741
2015/6/4,臺指選擇權,PUT,自營商,306164,830141,309833,918011,-3669,-87870,133259,1062326,123799,976118,9460,86208
2015/6/4,臺指選擇權,PUT,投信,100,193,129,1154,-29,-962,400,3420,100,465,300,2955
2015/6/4,臺指選擇權,PUT,外資及陸資,75049,313886,66557,329835,8492,-15949,225319,1707519,73682,884432,151637,823087
2015/6/5,臺指選擇權,CALL,自營商,236354,392417,240296,408555,-3942,-16138,106704,148736,248018,457161,-141314,-308425
2015/6/5,臺指選擇權,CALL,投信,0,0,0,0,0,0,100,8,700,106,-600,-98
2015/6/5,臺指選擇權,CALL,外資及陸資,56895,149236,50688,119152,6207,30084,256240,518672,122421,151113,133819,367559
2015/6/5,臺指選擇權,PUT,自營商,233021,595423,237349,656238,-4328,-60815,145121,993280,140330,967629,4791,25651
2015/6/5,臺指選擇權,PUT,投信,0,0,0,0,0,0,400,3355,100,435,300,2920
2015/6/5,臺指選擇權,PUT,外資及陸資,46602,185985,39597,172127,7005,13859,233452,1682676,74788,871685,158664,810991
2015/6/8,臺指選擇權,CALL,自營商,235928,420672,240561,400561,-4633,20110,116092,198470,262460,493834,-146368,-295364
2015/6/8,臺指選擇權,CALL,投信,0,0,0,0,0,0,100,5,700,78,-600,-73
2015/6/8,臺指選擇權,CALL,外資及陸資,43491,140500,38622,125848,4869,14652,262494,541053,123886,161000,138608,380053
2015/6/8,臺指選擇權,PUT,自營商,239174,480043,233843,458641,5331,21401,158158,855237,147600,831920,10558,23317
2015/6/8,臺指選擇權,PUT,投信,0,0,0,0,0,0,400,2555,100,315,300,2240
2015/6/8,臺指選擇權,PUT,外資及陸資,41707,151032,38017,145398,3690,5634,238581,1493513,76182,788194,162399,705319
2015/6/9,臺指選擇權,CALL,自營商,270587,358155,293627,342408,-23040,15747,124870,153280,294335,390992,-169465,-237712
2015/6/9,臺指選擇權,CALL,投信,1000,665,0,0,1000,665,1100,344,700,57,400,287
2015/6/9,臺指選擇權,CALL,外資及陸資,39825,97085,45201,112530,-5376,-15445,262112,459371,128845,145880,133267,313491
2015/6/9,臺指選擇權,PUT,自營商,294706,521635,312335,625480,-17629,-103844,155921,1156901,163021,1156250,-7100,651
2015/6/9,臺指選擇權,PUT,投信,0,0,20,101,-20,-101,400,4870,120,624,280,4246
2015/6/9,臺指選擇權,PUT,外資及陸資,50088,174674,54321,215663,-4233,-40989,236227,1932276,78108,1017682,158119,914594
2015/6/10,臺指選擇權,CALL,自營商,265687,385034,262987,399121,2700,-14087,87889,160767,222203,411304,-134314,-250537
2015/6/10,臺指選擇權,CALL,投信,400,581,200,217,200,364,1300,863,400,243,900,620
2015/6/10,臺指選擇權,CALL,外資及陸資,46505,142346,39416,130323,7089,12024,265486,530559,128957,188104,136529,342455
2015/6/10,臺指選擇權,PUT,自營商,238399,319025,259298,361874,-20899,-42848,115608,860163,140355,906853,-24747,-46690
2015/6/10,臺指選擇權,PUT,投信,10,39,0,0,10,39,100,675,110,479,-10,196
2015/6/10,臺指選擇權,PUT,外資及陸資,41601,120684,31441,103251,10160,17433,241900,1704615,77198,902543,164702,802072
2015/6/11,臺指選擇權,CALL,自營商,180155,253300,181344,304349,-1189,-51049,102720,148070,238333,440320,-135613,-292250
2015/6/11,臺指選擇權,CALL,投信,0,0,0,0,0,0,1300,627,400,189,900,438
2015/6/11,臺指選擇權,CALL,外資及陸資,25648,71570,24407,77666,1241,-6096,271026,530417,133187,195387,137839,335030
2015/6/11,臺指選擇權,PUT,自營商,170589,288357,148974,292328,21615,-3971,131855,843913,135116,897727,-3261,-53814
2015/6/11,臺指選擇權,PUT,投信,0,0,0,0,0,0,100,645,110,457,-10,188
2015/6/11,臺指選擇權,PUT,外資及陸資,33231,104347,24248,93945,8983,10401,249815,1683861,76141,892262,173674,791599
2015/6/12,臺指選擇權,CALL,自營商,150315,215433,145263,223259,5052,-7826,113876,140691,244462,427815,-130586,-287124
2015/6/12,臺指選擇權,CALL,投信,0,0,0,0,0,0,1300,382,400,109,900,273
2015/6/12,臺指選擇權,CALL,外資及陸資,24069,59172,24535,65879,-466,-6707,274522,501557,137144,189554,137378,312003
2015/6/12,臺指選擇權,PUT,自營商,140135,227491,135308,245552,4827,-18062,145998,863593,144502,937780,1496,-74187
2015/6/12,臺指選擇權,PUT,投信,0,0,0,0,0,0,100,700,110,473,-10,227
2015/6/12,臺指選擇權,PUT,外資及陸資,24378,87626,26571,95142,-2193,-7516,248786,1721741,77287,915643,171499,806098
2015/6/15,臺指選擇權,CALL,自營商,142527,191067,143412,195485,-885,-4418,116113,125837,247788,397687,-131675,-271850
2015/6/15,臺指選擇權,CALL,投信,0,0,0,0,0,0,1300,216,400,49,900,167
2015/6/15,臺指選擇權,CALL,外資及陸資,25891,64325,24690,63532,1201,793,277720,478342,139212,176854,138508,301488
2015/6/15,臺指選擇權,PUT,自營商,141140,248552,144526,264176,-3386,-15624,148353,895504,150188,986430,-1835,-90926
2015/6/15,臺指選擇權,PUT,投信,0,0,0,0,0,0,100,785,110,545,-10,240
2015/6/15,臺指選擇權,PUT,外資及陸資,29785,87086,26703,86202,3082,884,252099,1819201,77422,965066,174677,854135
2015/6/16,臺指選擇權,CALL,自營商,161316,194562,182036,220191,-20720,-25629,111832,125316,264285,391888,-152453,-266572
2015/6/16,臺指選擇權,CALL,投信,0,0,0,0,0,0,1300,68,400,30,900,38
2015/6/16,臺指選擇權,CALL,外資及陸資,21939,51799,24610,55018,-2671,-3219,279576,441400,143736,157040,135840,284360
2015/6/16,臺指選擇權,PUT,自營商,189438,392408,188840,425003,598,-32595,154000,991437,155187,1111618,-1187,-120181
2015/6/16,臺指選擇權,PUT,投信,100,300,0,0,100,300,200,1200,110,660,90,540
2015/6/16,臺指選擇權,PUT,外資及陸資,39639,136831,32493,122617,7146,14214,256676,1988315,74846,1043222,181830,945093
2015/6/17,臺指選擇權,CALL,自營商,168564,218453,183308,274229,-14744,-55776,43540,111361,97458,234645,-53918,-123284
2015/6/17,臺指選擇權,CALL,投信,0,0,0,0,0,0,0,0,200,22,-200,-22
2015/6/17,臺指選擇權,CALL,外資及陸資,26770,68533,27390,76389,-620,-7856,120486,239200,64876,150304,55610,88896
2015/6/17,臺指選擇權,PUT,自營商,169030,315517,177863,338370,-8833,-22853,67314,526357,49864,486972,17450,39385
2015/6/17,臺指選擇權,PUT,投信,110,649,50,170,60,479,100,255,50,163,50,92
2015/6/17,臺指選擇權,PUT,外資及陸資,23325,78158,23613,89090,-288,-10932,88216,1036926,33620,488480,54596,548446
2015/6/18,臺指選擇權,CALL,自營商,124448,207495,114193,211744,10255,-4249,67668,135569,111372,241865,-43704,-106296
2015/6/18,臺指選擇權,CALL,投信,200,13,0,0,200,13,0,0,0,0,0,0
2015/6/18,臺指選擇權,CALL,外資及陸資,25729,86961,23636,86998,2093,-37,129135,246199,71438,163981,57697,82218
2015/6/18,臺指選擇權,PUT,自營商,110486,225634,96156,216802,14330,8832,93762,561735,62005,512420,31757,49315
2015/6/18,臺指選擇權,PUT,投信,0,0,0,0,0,0,100,240,50,153,50,87
2015/6/18,臺指選擇權,PUT,外資及陸資,23638,85791,18124,78147,5514,7644,95894,1055942,35768,505282,60126,550660
2015/6/22,臺指選擇權,CALL,自營商,143235,309343,132053,266469,11182,42874,77197,224892,109723,349624,-32526,-124732
2015/6/22,臺指選擇權,CALL,投信,50,55,1,2,49,53,50,54,1,2,49,52
2015/6/22,臺指選擇權,CALL,外資及陸資,37751,133493,24985,92670,12766,40822,138230,324940,67737,199638,70493,125302
2015/6/22,臺指選擇權,PUT,自營商,142048,234404,153086,254389,-11038,-19985,101422,417152,80715,422075,20707,-4923
2015/6/22,臺指選擇權,PUT,投信,0,0,0,0,0,0,100,98,50,96,50,2
2015/6/22,臺指選擇權,PUT,外資及陸資,34099,109578,23998,70248,10101,39330,107064,879750,36840,402787,70224,476963
2015/6/23,臺指選擇權,CALL,自營商,139694,263308,151170,261556,-11476,1752,76321,257651,120347,398966,-44026,-141315
2015/6/23,臺指選擇權,CALL,投信,0,0,49,99,-49,-99,30,35,30,71,0,-36
2015/6/23,臺指選擇權,CALL,外資及陸資,34883,100460,27475,82719,7408,17741,148898,366708,70984,218113,77914,148595
2015/6/23,臺指選擇權,PUT,自營商,144973,219536,158278,203485,-13305,16051,101208,368913,93800,374375,7408,-5462
2015/6/23,臺指選擇權,PUT,投信,0,0,0,0,0,0,100,44,50,61,50,-17
2015/6/23,臺指選擇權,PUT,外資及陸資,22718,58365,16686,55845,6032,2520,112655,780573,36396,363763,76259,416810
2015/6/24,臺指選擇權,CALL,自營商,112031,188574,112083,183359,-52,5215,55821,186469,100213,273191,-44392,-86722
2015/6/24,臺指選擇權,CALL,投信,17,135,57,382,-40,-247,46,163,86,468,-40,-305
2015/6/24,臺指選擇權,CALL,外資及陸資,21575,73989,18557,56621,3018,17368,144376,369172,71318,216316,73058,152856
2015/6/24,臺指選擇權,PUT,自營商,111964,164688,119806,171502,-7842,-6814,78016,351649,61189,366163,16827,-14514
2015/6/24,臺指選擇權,PUT,投信,16,112,56,330,-40,-217,116,143,106,355,10,-212
2015/6/24,臺指選擇權,PUT,外資及陸資,17537,57543,14553,48820,2984,8723,112511,768858,34716,359122,77795,409736
2015/6/25,臺指選擇權,CALL,自營商,201873,443547,186142,422437,15731,21110,84345,305842,113140,414958,-28795,-109116
2015/6/25,臺指選擇權,CALL,投信,40,451,220,515,-180,-64,56,650,276,1159,-220,-509
2015/6/25,臺指選擇權,CALL,外資及陸資,42382,158045,33658,126635,8724,31410,153486,512023,71677,283026,81809,228997
2015/6/25,臺指選擇權,PUT,自營商,164948,301067,172355,334627,-7407,-33560,93238,312923,83762,372120,9476,-59197
2015/6/25,臺指選擇權,PUT,投信,40,364,40,270,0,93,156,447,146,509,10,-62
2015/6/25,臺指選擇權,PUT,外資及陸資,31961,107803,28544,94106,3417,13696,118920,676542,37701,315976,81219,360566
2015/6/26,臺指選擇權,CALL,自營商,85974,156209,95472,193421,-9498,-37212,92851,294102,131164,436665,-38313,-142563
2015/6/26,臺指選擇權,CALL,投信,0,0,0,0,0,0,56,633,276,1103,-220,-470
2015/6/26,臺指選擇權,CALL,外資及陸資,14632,43950,13203,42025,1429,1926,155367,494329,72127,271786,83240,222543
2015/6/26,臺指選擇權,PUT,自營商,84688,165437,75784,151325,8904,14112,108558,356718,90246,403067,18312,-46349
2015/6/26,臺指選擇權,PUT,投信,0,0,0,0,0,0,156,475,146,545,10,-70
2015/6/26,臺指選擇權,PUT,外資及陸資,19850,58279,14930,47586,4920,10693,124562,709509,38429,326033,86133,383476
2015/6/29,臺指選擇權,CALL,自營商,189826,312340,206679,319395,-16853,-7055,90590,186347,145788,251470,-55198,-65123
2015/6/29,臺指選擇權,CALL,投信,100,150,0,0,100,150,156,529,276,645,-120,-116
2015/6/29,臺指選擇權,CALL,外資及陸資,30090,93469,27755,83601,2335,9867,158955,347214,73387,177588,85568,169626
2015/6/29,臺指選擇權,PUT,自營商,234188,598247,239221,578893,-5033,19354,107552,649218,94440,618222,13112,30996
2015/6/29,臺指選擇權,PUT,投信,140,414,0,0,140,414,296,1296,146,1064,150,232
2015/6/29,臺指選擇權,PUT,外資及陸資,50029,197647,44773,177847,5256,19800,131007,1090189,39611,480820,91396,609369
2015/6/30,臺指選擇權,CALL,自營商,133748,214306,132549,206710,1199,7596,94500,230088,148484,297304,-53984,-67216
2015/6/30,臺指選擇權,CALL,投信,0,0,0,0,0,0,156,638,276,759,-120,-121
2015/6/30,臺指選擇權,CALL,外資及陸資,23248,70873,23363,73353,-115,-2480,160826,391152,75381,209171,85445,181981
2015/6/30,臺指選擇權,PUT,自營商,144649,219814,150084,249481,-5435,-29667,106059,475450,98442,495055,7617,-19605
2015/6/30,臺指選擇權,PUT,投信,0,0,0,0,0,0,296,917,146,833,150,84
2015/6/30,臺指選擇權,PUT,外資及陸資,23691,69253,24136,69855,-445,-603,132055,916946,41083,413205,90972,503741
2015/7/1,臺指選擇權,CALL,自營商,203836,398923,187783,378966,16053,19957,79463,278062,110468,360134,-31005,-82072
2015/7/1,臺指選擇權,CALL,投信,0,0,30,83,-30,-83,126,771,276,967,-150,-196
2015/7/1,臺指選擇權,CALL,外資及陸資,36747,137890,34119,114998,2628,22892,157770,474391,74936,251657,82834,222734
2015/7/1,臺指選擇權,PUT,自營商,172824,242895,187533,261936,-14709,-19041,88763,352026,74787,406226,13976,-54200
2015/7/1,臺指選擇權,PUT,投信,0,0,0,0,0,0,296,681,146,649,150,32
2015/7/1,臺指選擇權,PUT,外資及陸資,27153,83980,23497,65813,3656,18167,133031,805025,39245,351630,93786,453395
2015/7/2,臺指選擇權,CALL,自營商,114983,184422,122661,234939,-7678,-50518,98092,266702,136721,387113,-38629,-120411
2015/7/2,臺指選擇權,CALL,投信,0,0,0,0,0,0,126,708,276,895,-150,-187
2015/7/2,臺指選擇權,CALL,外資及陸資,18356,74487,21571,83594,-3215,-9108,159907,465149,80275,261689,79632,203460
2015/7/2,臺指選擇權,PUT,自營商,98883,194768,87535,170942,11348,23826,110572,417141,85273,446287,25299,-29146
2015/7/2,臺指選擇權,PUT,投信,0,0,0,0,0,0,296,680,146,655,150,25
2015/7/2,臺指選擇權,PUT,外資及陸資,19319,61227,16506,65441,2813,-4214,138488,825641,41879,373916,96609,451725
2015/7/3,臺指選擇權,CALL,自營商,178529,352173,178385,345572,144,6601,106754,315052,145189,447479,-38435,-132427
2015/7/3,臺指選擇權,CALL,投信,20,31,0,0,20,31,146,821,276,951,-130,-130
2015/7/3,臺指選擇權,CALL,外資及陸資,32400,99631,28557,96125,3843,3506,164935,502523,81460,286571,83475,215952
2015/7/3,臺指選擇權,PUT,自營商,163586,352358,161215,340412,2371,11946,124781,409797,97160,439610,27621,-29813
2015/7/3,臺指選擇權,PUT,投信,0,0,0,0,0,0,296,620,146,597,150,23
2015/7/3,臺指選擇權,PUT,外資及陸資,32772,105772,25285,98005,7487,7767,146224,801217,42113,362114,104111,439103
2015/7/6,臺指選擇權,CALL,自營商,167916,290884,182295,335955,-14379,-45071,111631,221542,164519,335255,-52888,-113713
2015/7/6,臺指選擇權,CALL,投信,0,0,0,0,0,0,146,554,276,685,-130,-131
2015/7/6,臺指選擇權,CALL,外資及陸資,29704,89422,29954,95859,-250,-6437,164814,391172,81528,222555,83286,168617
2015/7/6,臺指選擇權,PUT,自營商,163378,336612,164145,328300,-767,8311,133581,564911,106854,575653,26727,-10742
2015/7/6,臺指選擇權,PUT,投信,100,259,0,0,100,259,396,1124,146,833,250,291
2015/7/6,臺指選擇權,PUT,外資及陸資,34209,119657,31420,118682,2789,976,149909,979003,43022,442181,106887,536822
2015/7/7,臺指選擇權,CALL,自營商,181929,310820,170347,273893,11582,36926,114320,242649,155594,332113,-41274,-89464
2015/7/7,臺指選擇權,CALL,投信,0,0,0,0,0,0,146,588,276,745,-130,-157
2015/7/7,臺指選擇權,CALL,外資及陸資,34229,103803,35858,112549,-1629,-8746,167016,409661,85413,242768,81603,166893
2015/7/7,臺指選擇權,PUT,自營商,179308,288650,185843,314892,-6535,-26242,134691,459988,114448,525474,20243,-65486
2015/7/7,臺指選擇權,PUT,投信,0,0,0,0,0,0,396,799,146,673,250,126
2015/7/7,臺指選擇權,PUT,外資及陸資,34851,106509,35047,108518,-196,-2009,151807,862837,45116,402296,106691,460541
2015/7/8,臺指選擇權,CALL,自營商,366898,441230,473940,552366,-107042,-111136,77497,107412,182688,220024,-105191,-112612
2015/7/8,臺指選擇權,CALL,投信,4,36,4,14,0,22,150,270,280,319,-130,-49
2015/7/8,臺指選擇權,CALL,外資及陸資,60028,184745,56712,150115,3316,34629,174044,295343,91784,146103,82260,149240
2015/7/8,臺指選擇權,PUT,自營商,378827,1066785,383647,1089013,-4820,-22229,101685,815221,90514,884903,11171,-69682
2015/7/8,臺指選擇權,PUT,投信,204,456,114,953,90,-497,500,2359,160,1727,340,632
2015/7/8,臺指選擇權,PUT,外資及陸資,102800,478474,88450,463270,14350,15204,162949,1681257,45812,735212,117137,946045
2015/7/9,臺指選擇權,CALL,自營商,283278,535280,301720,573101,-18442,-37821,98743,148727,222324,281500,-123581,-132773
2015/7/9,臺指選擇權,CALL,投信,0,0,0,0,0,0,150,218,280,249,-130,-31
2015/7/9,臺指選擇權,CALL,外資及陸資,62897,210679,58212,186511,4685,24168,187806,313201,101099,160773,86707,152428
2015/7/9,臺指選擇權,PUT,自營商,307505,903250,313467,1058470,-5962,-155220,117950,937382,113160,1089959,4790,-152577
2015/7/9,臺指選擇權,PUT,投信,0,0,240,1616,-240,-1616,400,2265,300,2808,100,-543
2015/7/9,臺指選擇權,PUT,外資及陸資,86829,385689,90650,463424,-3821,-77735,164789,1912654,51212,852287,113577,1060367
2015/7/13,臺指選擇權,CALL,自營商,217746,393325,220278,385502,-2532,7823,97514,165102,223680,324156,-126166,-159054
2015/7/13,臺指選擇權,CALL,投信,0,0,0,0,0,0,150,252,280,278,-130,-26
2015/7/13,臺指選擇權,CALL,外資及陸資,49359,151774,47840,149046,1519,2727,193885,368991,105642,203661,88243,165330
2015/7/13,臺指選擇權,PUT,自營商,207191,353741,206415,327392,776,26350,123997,643451,118500,778186,5497,-134735
2015/7/13,臺指選擇權,PUT,投信,0,0,0,0,0,0,400,1160,300,1825,100,-665
2015/7/13,臺指選擇權,PUT,外資及陸資,39290,130171,35514,121427,3776,8743,169866,1447724,52538,680792,117328,766932
2015/7/14,臺指選擇權,CALL,自營商,203137,316413,203086,327779,51,-11365,102535,155550,228521,274252,-125986,-118702
2015/7/14,臺指選擇權,CALL,投信,0,0,0,0,0,0,150,200,280,204,-130,-4
2015/7/14,臺指選擇權,CALL,外資及陸資,37622,124134,38182,122590,-560,1544,200346,340297,112573,185845,87773,154452
2015/7/14,臺指選擇權,PUT,自營商,169792,284134,175414,280513,-5622,3621,124862,638540,124942,771712,-80,-133172
2015/7/14,臺指選擇權,PUT,投信,0,0,0,0,0,0,400,1091,300,1748,100,-657
2015/7/14,臺指選擇權,PUT,外資及陸資,27414,103502,30340,106214,-2926,-2712,169365,1430354,54989,682446,114376,747908
2015/7/15,臺指選擇權,CALL,自營商,225224,379245,230576,362403,-5352,16842,46753,124286,74139,234985,-27386,-110699
2015/7/15,臺指選擇權,CALL,投信,0,0,40,118,-40,-118,60,229,280,362,-220,-133
2015/7/15,臺指選擇權,CALL,外資及陸資,36898,105914,32925,99985,3973,5928,134329,326700,66749,162682,67580,164018
2015/7/15,臺指選擇權,PUT,自營商,213480,380938,229808,409215,-16328,-28277,64019,372222,47159,397675,16860,-25453
2015/7/15,臺指選擇權,PUT,投信,0,0,40,140,-40,-140,60,944,300,1357,-240,-413
2015/7/15,臺指選擇權,PUT,外資及陸資,29708,122882,28806,105715,902,17167,104186,914386,40842,450225,63344,464161
2015/7/16,臺指選擇權,CALL,自營商,134154,245545,127166,243724,6988,1822,64072,144320,84491,257668,-20419,-113348
2015/7/16,臺指選擇權,CALL,投信,250,615,150,660,100,-45,210,816,330,968,-120,-152
2015/7/16,臺指選擇權,CALL,外資及陸資,31569,101090,28295,94231,3274,6859,138111,338416,67276,167674,70835,170742
2015/7/16,臺指選擇權,PUT,自營商,121599,240305,111943,228145,9656,12161,85047,364398,58570,382012,26477,-17614
2015/7/16,臺指選擇權,PUT,投信,200,229,0,0,200,229,210,1042,250,1115,-40,-73
2015/7/16,臺指選擇權,PUT,外資及陸資,27433,87563,24375,84637,3058,2926,109758,854568,43301,426127,66457,428441
2015/7/17,臺指選擇權,CALL,自營商,109015,191819,109319,215043,-304,-23224,77784,154478,98533,285299,-20749,-130821
2015/7/17,臺指選擇權,CALL,投信,0,0,0,0,0,0,210,774,330,939,-120,-165
2015/7/17,臺指選擇權,CALL,外資及陸資,23482,69195,25809,79359,-2327,-10164,139712,329280,71199,173641,68513,155639
2015/7/17,臺指選擇權,PUT,自營商,97107,193796,97365,212579,-258,-18783,94879,372279,68751,406768,26128,-34489
2015/7/17,臺指選擇權,PUT,投信,0,0,0,0,0,0,210,1039,250,1114,-40,-75
2015/7/17,臺指選擇權,PUT,外資及陸資,26873,75872,24750,86559,2123,-10687,114168,856802,45569,434671,68599,422131
2015/7/20,臺指選擇權,CALL,自營商,217309,448011,225943,424718,-8634,23292,87508,153976,116929,237627,-29421,-83651
2015/7/20,臺指選擇權,CALL,投信,0,0,0,0,0,0,210,564,330,717,-120,-153
2015/7/20,臺指選擇權,CALL,外資及陸資,41074,134959,37249,121656,3825,13303,142984,280464,70617,139014,72367,141450
2015/7/20,臺指選擇權,PUT,自營商,207140,467448,211112,445556,-3972,21892,102848,481356,80698,501609,22150,-20253
2015/7/20,臺指選擇權,PUT,投信,0,0,100,1575,-100,-1575,210,1208,350,2968,-140,-1760
2015/7/20,臺指選擇權,PUT,外資及陸資,37556,126405,34921,119556,2635,6848,116986,942972,45740,474627,71246,468345
2015/7/21,臺指選擇權,CALL,自營商,160747,251815,161047,247197,-300,4619,93008,218464,122660,319223,-29652,-100759
2015/7/21,臺指選擇權,CALL,投信,0,0,0,0,0,0,210,775,330,929,-120,-154
2015/7/21,臺指選擇權,CALL,外資及陸資,27537,74206,23912,72526,3625,1680,144572,338316,68593,167357,75979,170959
2015/7/21,臺指選擇權,PUT,自營商,143729,251227,146214,250771,-2485,456,107358,380956,87754,397888,19604,-16932
2015/7/21,臺指選擇權,PUT,投信,0,0,0,0,0,0,210,926,350,2389,-140,-1463
2015/7/21,臺指選擇權,PUT,外資及陸資,28227,85374,25774,78271,2453,7103,119322,802407,45628,400842,73694,401565
2015/7/22,臺指選擇權,CALL,自營商,223304,333778,253215,342292,-29911,-8514,59018,139888,99757,206898,-40739,-67010
2015/7/22,臺指選擇權,CALL,投信,0,0,0,0,0,0,210,427,330,559,-120,-132
2015/7/22,臺指選擇權,CALL,外資及陸資,30321,85439,30798,86854,-477,-1415,139953,249032,71845,124573,68108,124459
2015/7/22,臺指選擇權,PUT,自營商,220484,441618,221287,427925,-803,13693,89960,475737,68043,496088,21917,-20351
2015/7/22,臺指選擇權,PUT,投信,0,0,0,0,0,0,210,1296,350,3155,-140,-1859
2015/7/22,臺指選擇權,PUT,外資及陸資,39534,126249,36707,130179,2827,-3930,120107,990192,45826,496425,74281,493767
2015/7/23,臺指選擇權,CALL,自營商,224558,400178,243088,433332,-18530,-33154,82568,154253,141831,234760,-59263,-80507
2015/7/23,臺指選擇權,CALL,投信,0,0,50,3,-50,-3,210,289,380,432,-170,-143
2015/7/23,臺指選擇權,CALL,外資及陸資,43520,131867,46078,135862,-2558,-3995,146436,224820,80956,124206,65480,100614
2015/7/23,臺指選擇權,PUT,自營商,218617,580225,202210,567866,16407,12359,118728,566179,80370,570350,38358,-4171
2015/7/23,臺指選擇權,PUT,投信,0,0,0,0,0,0,210,1453,350,3479,-140,-2026
2015/7/23,臺指選擇權,PUT,外資及陸資,55799,216886,47663,193790,8136,23096,129958,1098959,47408,543826,82550,555133
2015/7/24,臺指選擇權,CALL,自營商,134023,217351,144640,236487,-10617,-19135,88459,125458,158358,187995,-69899,-62537
2015/7/24,臺指選擇權,CALL,投信,0,0,0,0,0,0,210,178,380,298,-170,-120
2015/7/24,臺指選擇權,CALL,外資及陸資,22761,68104,22264,66002,497,2102,149536,186635,83556,99521,65980,87114
2015/7/24,臺指選擇權,PUT,自營商,125684,312667,130193,335632,-4509,-22965,123517,655096,89790,670218,33727,-15122
2015/7/24,臺指選擇權,PUT,投信,0,0,0,0,0,0,210,1685,350,3968,-140,-2283
2015/7/24,臺指選擇權,PUT,外資及陸資,32978,114631,27349,116188,5629,-1556,137110,1230267,48939,612767,88171,617500
2015/7/27,臺指選擇權,CALL,自營商,249468,390486,290048,411190,-40580,-20704,95017,103658,205540,139230,-110523,-35572
2015/7/27,臺指選擇權,CALL,投信,0,0,0,0,0,0,210,79,380,171,-170,-92
2015/7/27,臺指選擇權,CALL,外資及陸資,38048,107347,41124,109344,-3076,-1997,153492,135431,90363,73882,63129,61549
2015/7/27,臺指選擇權,PUT,自營商,227546,578980,237411,663234,-9865,-84253,137075,959357,113222,1020540,23853,-61183
2015/7/27,臺指選擇權,PUT,投信,100,238,0,0,100,238,310,2824,350,5477,-40,-2653
2015/7/27,臺指選擇權,PUT,外資及陸資,53375,207152,47962,206721,5413,431,145142,1655134,51535,816799,93607,838335
2015/7/28,臺指選擇權,CALL,自營商,183922,268956,195541,297096,-11619,-28140,107098,116097,229395,178911,-122297,-62814
2015/7/28,臺指選擇權,CALL,投信,0,0,0,0,0,0,210,65,380,162,-170,-97
2015/7/28,臺指選擇權,CALL,外資及陸資,39223,112721,37634,99441,1589,13281,158005,162589,93279,85215,64726,77374
2015/7/28,臺指選擇權,PUT,自營商,189999,357476,196800,396562,-6801,-39086,140560,893442,123241,994441,17319,-100999
2015/7/28,臺指選擇權,PUT,投信,0,0,100,323,-100,-323,210,2329,350,5257,-140,-2928
2015/7/28,臺指選擇權,PUT,外資及陸資,45523,155611,36049,127596,9474,28015,156114,1642237,53096,805053,103018,837184
2015/7/29,臺指選擇權,CALL,自營商,251660,363553,275421,385384,-23761,-21831,75421,124190,170374,182014,-94953,-57824
2015/7/29,臺指選擇權,CALL,投信,0,0,0,0,0,0,210,49,380,130,-170,-81
2015/7/29,臺指選擇權,CALL,外資及陸資,39205,108484,40326,108151,-1121,333,159200,157113,96143,87538,63057,69575
2015/7/29,臺指選擇權,PUT,自營商,261025,638572,275118,590200,-14093,48373,111697,831629,97692,919359,14005,-87730
2015/7/29,臺指選擇權,PUT,投信,0,0,0,0,0,0,210,2627,350,5821,-140,-3194
2015/7/29,臺指選擇權,PUT,外資及陸資,42527,161749,41864,166546,663,-4797,152648,1764573,52233,867519,100415,897054
2015/7/30,臺指選擇權,CALL,自營商,193634,421481,169827,377091,23807,44389,91997,185390,163259,235399,-71262,-50009
2015/7/30,臺指選擇權,CALL,投信,0,0,0,0,0,0,210,60,380,157,-170,-97
2015/7/30,臺指選擇權,CALL,外資及陸資,44986,149197,33244,116119,11742,33079,169404,221478,94606,106218,74798,115260
2015/7/30,臺指選擇權,PUT,自營商,174156,384666,183313,406635,-9157,-21969,114689,590201,109807,708231,4882,-118030
2015/7/30,臺指選擇權,PUT,投信,0,0,0,0,0,0,210,1922,350,4465,-140,-2543
2015/7/30,臺指選擇權,PUT,外資及陸資,33207,132633,28609,101101,4598,31531,157936,1406528,52937,692810,104999,713718
2015/7/31,臺指選擇權,CALL,自營商,127716,216332,136928,252001,-9212,-35669,93937,169090,174663,241976,-80726,-72886
2015/7/31,臺指選擇權,CALL,投信,400,1537,0,0,400,1537,610,1941,380,127,230,1814
2015/7/31,臺指選擇權,CALL,外資及陸資,26992,78792,28304,82536,-1312,-3743,169443,197565,95956,98822,73487,98743
2015/7/31,臺指選擇權,PUT,自營商,130847,269421,125004,268224,5843,1198,125225,637912,114514,753044,10711,-115132
2015/7/31,臺指選擇權,PUT,投信,0,0,0,0,0,0,210,2068,350,4757,-140,-2689
2015/7/31,臺指選擇權,PUT,外資及陸資,27733,90810,27580,98480,153,-7670,158043,1485683,52868,729291,105175,756392
2015/8/3,臺指選擇權,CALL,自營商,189906,316433,198328,309270,-8422,7164,98758,138406,187959,147591,-89201,-9185
2015/8/3,臺指選擇權,CALL,投信,0,0,0,0,0,0,610,962,380,76,230,886
2015/8/3,臺指選擇權,CALL,外資及陸資,34071,82441,33380,91300,691,-8859,173298,142735,99063,80797,74235,61938
2015/8/3,臺指選擇權,PUT,自營商,205059,510116,216652,540260,-11593,-30144,121772,828653,122838,973010,-1066,-144357
2015/8/3,臺指選擇權,PUT,投信,0,0,0,0,0,0,210,2720,350,6050,-140,-3330
2015/8/3,臺指選擇權,PUT,外資及陸資,46322,167776,46015,176516,307,-8740,159867,1860220,54418,898786,105449,961434
2015/8/4,臺指選擇權,CALL,自營商,231361,365423,226043,362110,5318,3313,109209,159368,193134,168226,-83925,-8858
2015/8/4,臺指選擇權,CALL,投信,0,0,0,0,0,0,610,1066,380,81,230,985
2015/8/4,臺指選擇權,CALL,外資及陸資,41465,106020,38573,104530,2892,1490,176961,157456,99853,92231,77108,65225
2015/8/4,臺指選擇權,PUT,自營商,239606,456524,248907,495668,-9301,-39144,122847,812904,132688,1010886,-9841,-197982
2015/8/4,臺指選擇權,PUT,投信,140,455,0,0,140,455,310,2883,310,5722,0,-2839
2015/8/4,臺指選擇權,PUT,外資及陸資,45140,139958,45299,139525,-159,433,160531,1822826,55241,883543,105290,939283
2015/8/5,臺指選擇權,CALL,自營商,233482,347069,221276,340309,12206,6760,83936,177677,170455,195562,-86519,-17885
2015/8/5,臺指選擇權,CALL,投信,100,880,0,0,100,880,710,2268,380,110,330,2158
2015/8/5,臺指選擇權,CALL,外資及陸資,38190,98066,39691,102601,-1501,-4535,173285,187895,103275,112986,70010,74909
2015/8/5,臺指選擇權,PUT,自營商,222855,358048,229638,356141,-6783,1908,108232,702581,111007,857593,-2775,-155012
2015/8/5,臺指選擇權,PUT,投信,20,89,0,0,20,89,310,2421,290,4972,20,-2551
2015/8/5,臺指選擇權,PUT,外資及陸資,32238,90517,31330,92895,908,-2378,160407,1638323,56330,806691,104077,831632
2015/8/6,臺指選擇權,CALL,自營商,270512,442037,285116,484975,-14604,-42938,110300,142273,211419,158019,-101119,-15746
2015/8/6,臺指選擇權,CALL,投信,0,0,0,0,0,0,710,951,380,65,330,886
2015/8/6,臺指選擇權,CALL,外資及陸資,41335,123134,40551,135364,784,-12229,179711,140352,108908,89306,70803,51046
2015/8/6,臺指選擇權,PUT,自營商,235217,575784,237876,641036,-2659,-65252,116960,929446,122410,1165299,-5450,-235853
2015/8/6,臺指選擇權,PUT,投信,0,0,0,0,0,0,310,3318,290,6273,20,-2955
2015/8/6,臺指選擇權,PUT,外資及陸資,41241,179284,37698,163501,3543,15784,165077,2073568,57371,993534,107706,1080034
2015/8/7,臺指選擇權,CALL,自營商,212404,350871,221117,349174,-8713,1697,122547,177761,232370,189297,-109823,-11536
2015/8/7,臺指選擇權,CALL,投信,0,0,0,0,0,0,710,836,380,57,330,779
2015/8/7,臺指選擇權,CALL,外資及陸資,34015,99788,33554,91615,461,8174,182441,142049,111156,85498,71285,56551
2015/8/7,臺指選擇權,PUT,自營商,203851,451793,206691,508514,-2840,-56720,127979,907223,136432,1181366,-8453,-274143
2015/8/7,臺指選擇權,PUT,投信,30,171,0,0,30,171,310,3248,260,6082,50,-2834
2015/8/7,臺指選擇權,PUT,外資及陸資,35384,135990,38183,148216,-2799,-12226,162736,2060020,57865,995478,104871,1064542
2015/8/10,臺指選擇權,CALL,自營商,184334,308574,186825,301493,-2491,7081,125616,216951,237983,232717,-112367,-15766
2015/8/10,臺指選擇權,CALL,投信,0,0,0,0,0,0,710,1029,380,54,330,975
2015/8/10,臺指選擇權,CALL,外資及陸資,37475,98135,35255,90948,2220,7187,184751,160132,111219,93237,73532,66895
2015/8/10,臺指選擇權,PUT,自營商,174547,317479,170886,318033,3661,-555,136507,785425,141319,1022992,-4812,-237567
2015/8/10,臺指選擇權,PUT,投信,0,0,0,0,0,0,310,2713,260,5483,50,-2770
2015/8/10,臺指選擇權,PUT,外資及陸資,34543,103049,31492,106443,3051,-3394,165933,1841032,57989,910179,107944,930853
2015/8/11,臺指選擇權,CALL,自營商,338675,517994,340547,513465,-1872,4529,135522,164334,249702,151807,-114180,12527
2015/8/11,臺指選擇權,CALL,投信,0,0,0,0,0,0,710,500,380,42,330,458
2015/8/11,臺指選擇權,CALL,外資及陸資,55217,151299,52451,149857,2766,1443,192829,146053,116445,82333,76384,63720
2015/8/11,臺指選擇權,PUT,自營商,303956,558267,320852,648401,-16896,-90134,134048,971728,155747,1362973,-21699,-391245
2015/8/11,臺指選擇權,PUT,投信,60,195,90,460,-30,-265,280,3219,260,6353,20,-3134
2015/8/11,臺指選擇權,PUT,外資及陸資,60766,192376,56933,183175,3833,9201,173261,2185224,61505,1051780,111756,1133444
2015/8/12,臺指選擇權,CALL,自營商,342426,450363,372434,433422,-30008,16941,102978,170184,220950,132796,-117972,37388
2015/8/12,臺指選擇權,CALL,投信,0,0,0,0,0,0,710,264,380,31,330,233
2015/8/12,臺指選擇權,CALL,外資及陸資,49664,114949,53686,123977,-4022,-9028,196141,140918,121213,87985,74928,52933
2015/8/12,臺指選擇權,PUT,自營商,372458,816352,387459,930613,-15001,-114262,106728,975157,138056,1395003,-31328,-419846
2015/8/12,臺指選擇權,PUT,投信,5,27,0,0,5,27,285,3726,260,6987,25,-3261
2015/8/12,臺指選擇權,PUT,外資及陸資,72539,248796,70319,257604,2220,-8808,169697,2381123,60339,1130941,109358,1250182
2015/8/13,臺指選擇權,CALL,自營商,191095,277398,197602,347042,-6507,-69644,119438,151885,244106,182933,-124668,-31048
2015/8/13,臺指選擇權,CALL,投信,0,0,0,0,0,0,710,209,380,28,330,181
2015/8/13,臺指選擇權,CALL,外資及陸資,37658,108790,32297,97110,5361,11680,203875,151037,123640,87841,80235,63196
2015/8/13,臺指選擇權,PUT,自營商,182729,348669,157388,336110,25341,12559,138384,948409,144402,1349803,-6018,-401394
2015/8/13,臺指選擇權,PUT,投信,0,0,115,346,-115,-346,170,3196,260,6935,-90,-3739
2015/8/13,臺指選擇權,PUT,外資及陸資,39270,132748,41602,152025,-2332,-19277,169695,2330791,62552,1127970,107143,1202821
2015/8/14,臺指選擇權,CALL,自營商,138234,193767,132406,184949,5828,8818,134741,166518,253737,185060,-118996,-18542
2015/8/14,臺指選擇權,CALL,投信,0,0,3,14,-3,-14,710,126,383,34,327,92
2015/8/14,臺指選擇權,CALL,外資及陸資,26584,74595,24140,71046,2444,3550,210138,146829,127477,89105,82661,57724
2015/8/14,臺指選擇權,PUT,自營商,132600,235569,133652,262449,-1052,-26880,145978,867062,153107,1280532,-7129,-413470
2015/8/14,臺指選擇權,PUT,投信,8,27,5,3,3,24,178,3007,265,6669,-87,-3662
2015/8/14,臺指選擇權,PUT,外資及陸資,24880,84261,23019,83181,1861,1080,172230,2225606,63211,1089811,109019,1135795
2015/8/17,臺指選擇權,CALL,自營商,137458,174689,159526,197267,-22068,-22578,132302,120269,273518,138598,-141216,-18329
2015/8/17,臺指選擇權,CALL,投信,0,0,0,0,0,0,710,32,383,18,327,14
2015/8/17,臺指選擇權,CALL,外資及陸資,26794,67990,24711,68246,2083,-257,213571,115741,128758,68894,84813,46847
2015/8/17,臺指選擇權,PUT,自營商,145250,326831,142178,329100,3072,-2269,143463,1032821,147577,1514128,-4114,-481307
2015/8/17,臺指選擇權,PUT,投信,0,0,0,0,0,0,178,3669,265,7767,-87,-4098
2015/8/17,臺指選擇權,PUT,外資及陸資,30667,113615,30699,122377,-32,-8762,171524,2571421,62557,1236440,108967,1334981
2015/8/18,臺指選擇權,CALL,自營商,168999,214305,190926,214643,-21927,-338,138141,117094,301312,119233,-163171,-2139
2015/8/18,臺指選擇權,CALL,投信,0,0,0,0,0,0,710,12,383,11,327,1
2015/8/18,臺指選擇權,CALL,外資及陸資,31564,81529,25700,73191,5864,8339,222991,113192,132225,69814,90766,43378
2015/8/18,臺指選擇權,PUT,自營商,159995,427624,162129,413533,-2134,14091,130860,1171507,137221,1702103,-6361,-530596
2015/8/18,臺指選擇權,PUT,投信,0,0,0,0,0,0,178,4249,265,8664,-87,-4415
2015/8/18,臺指選擇權,PUT,外資及陸資,46463,201556,45722,254388,741,-52833,173940,2844665,64294,1381989,109646,1462676
2015/8/19,臺指選擇權,CALL,自營商,259784,368754,339562,395948,-79778,-27194,63031,122712,113165,140798,-50134,-18086
2015/8/19,臺指選擇權,CALL,投信,88,483,112,449,-24,35,88,488,312,462,-224,26
2015/8/19,臺指選擇權,CALL,外資及陸資,29970,74600,30319,101456,-349,-26856,141703,94032,85945,83925,55758,10107
2015/8/19,臺指選擇權,PUT,自營商,314920,903963,358841,1112719,-43921,-208756,66657,733538,74703,1197716,-8046,-464178
2015/8/19,臺指選擇權,PUT,投信,80,653,112,676,-32,-23,80,668,162,4309,-82,-3641
2015/8/19,臺指選擇權,PUT,外資及陸資,54104,233637,54720,303964,-616,-70327,101880,2347376,46693,1144539,55187,1202837
2015/8/20,臺指選擇權,CALL,自營商,233471,480377,230821,473570,2650,6806,95007,191765,142519,189594,-47512,2171
2015/8/20,臺指選擇權,CALL,投信,2,12,8,18,-6,-5,90,466,320,414,-230,52
2015/8/20,臺指選擇權,CALL,外資及陸資,59750,202265,58990,172272,760,29994,155878,133596,99373,101020,56505,32576
2015/8/20,臺指選擇權,PUT,自營商,190981,578001,195317,618954,-4336,-40953,85716,733058,98096,1230176,-12380,-497118
2015/8/20,臺指選擇權,PUT,投信,4,19,6,11,-2,8,80,636,164,4223,-84,-3587
2015/8/20,臺指選擇權,PUT,外資及陸資,46880,187775,44569,208276,2311,-20500,106275,2333313,48663,1157907,57612,1175406
2015/8/21,臺指選擇權,CALL,自營商,240888,474348,262977,441528,-22089,32820,108299,189389,178047,112166,-69748,77223
2015/8/21,臺指選擇權,CALL,投信,10,38,178,24,-168,14,100,236,498,138,-398,98
2015/8/21,臺指選擇權,CALL,外資及陸資,40582,120708,41082,134545,-500,-13837,161447,93379,105448,81449,55999,11930
2015/8/21,臺指選擇權,PUT,自營商,223523,833521,237032,1004916,-13509,-171396,95914,1155853,121757,2004215,-25843,-848362
2015/8/21,臺指選擇權,PUT,投信,22,121,6,13,16,108,102,1328,170,5717,-68,-4389
2015/8/21,臺指選擇權,PUT,外資及陸資,67049,295483,51097,280582,15952,14901,126049,3203910,52474,1572493,73575,1631417
2015/8/24,臺指選擇權,CALL,自營商,391322,1442105,401082,1303509,-9760,138596,160241,470664,239873,225988,-79632,244676
2015/8/24,臺指選擇權,CALL,投信,46,447,95,434,-49,13,146,605,593,592,-447,13
2015/8/24,臺指選擇權,CALL,外資及陸資,88373,291956,87993,357531,380,-65575,165082,131813,108761,167767,56321,-35954
2015/8/24,臺指選擇權,PUT,自營商,377161,3775321,406253,4817333,-29092,-1042012,92241,2269718,147084,4501425,-54843,-2231707
2015/8/24,臺指選擇權,PUT,投信,0,0,78,1251,-78,-1251,102,3205,248,9573,-146,-6368
2015/8/24,臺指選擇權,PUT,外資及陸資,112135,1076587,112354,1347728,-219,-271141,132287,5490115,58888,2791817,73399,2698298
2015/8/25,臺指選擇權,CALL,自營商,245953,835652,250329,824533,-4376,11119,164959,660596,249224,340347,-84265,320249
2015/8/25,臺指選擇權,CALL,投信,24,102,0,0,24,102,170,1081,593,716,-423,365
2015/8/25,臺指選擇權,CALL,外資及陸資,59122,252696,51294,237578,7828,15118,176236,187557,112071,228922,64165,-41365
2015/8/25,臺指選擇權,PUT,自營商,293861,1335734,289565,1271239,4296,64495,108217,1443924,158705,3060723,-50488,-1616799
2015/8/25,臺指選擇權,PUT,投信,0,0,0,0,0,0,102,2111,248,7245,-146,-5134
2015/8/25,臺指選擇權,PUT,外資及陸資,75197,370469,76993,361419,-1796,9049,141942,4217913,70323,2186986,71619,2030927
2015/8/26,臺指選擇權,CALL,自營商,336772,833661,347515,801743,-10743,31918,128126,618260,156027,292174,-27901,326086
2015/8/26,臺指選擇權,CALL,投信,20,163,118,290,-98,-127,60,283,543,879,-483,-596
2015/8/26,臺指選擇權,CALL,外資及陸資,64961,193194,66358,201174,-1397,-7979,168768,154984,110129,216495,58639,-61511
2015/8/26,臺指選擇權,PUT,自營商,311800,819289,338301,802661,-26501,16628,78279,1132116,124742,2635788,-46463,-1503672
2015/8/26,臺指選擇權,PUT,投信,50,15,78,862,-28,-847,40,1060,196,5802,-156,-4742
2015/8/26,臺指選擇權,PUT,外資及陸資,70850,239583,70308,271693,542,-32110,135169,3934499,71685,2061835,63484,1872664
2015/8/27,臺指選擇權,CALL,自營商,130083,426722,131405,467795,-1322,-41073,138374,650340,167713,343162,-29339,307178
2015/8/27,臺指選擇權,CALL,投信,265,806,14,41,251,765,60,317,292,219,-232,98
2015/8/27,臺指選擇權,CALL,外資及陸資,33522,158067,33322,156131,200,1936,170489,153276,111668,224836,58821,-71560
2015/8/27,臺指選擇權,PUT,自營商,113996,447009,116950,492305,-2954,-45296,85301,974197,134699,2366489,-49398,-1392292
2015/8/27,臺指選擇權,PUT,投信,68,112,14,89,54,23,40,910,142,5283,-102,-4373
2015/8/27,臺指選擇權,PUT,外資及陸資,43586,191058,36325,190099,7261,958,144527,3590881,73779,1895097,70748,1695784
2015/8/28,臺指選擇權,CALL,自營商,170598,606306,152182,588188,18416,18119,151737,1029056,162570,586518,-10833,442538
2015/8/28,臺指選擇權,CALL,投信,20,124,16,44,4,80,80,714,308,556,-228,158
2015/8/28,臺指選擇權,CALL,外資及陸資,47500,228004,46811,228633,689,-628,174552,269699,114973,350643,59579,-80944
2015/8/28,臺指選擇權,PUT,自營商,161174,509753,177965,556406,-16791,-46652,100787,784973,166992,1936587,-66205,-1151614
2015/8/28,臺指選擇權,PUT,投信,0,0,8,55,-8,-55,40,620,150,4474,-110,-3854
2015/8/28,臺指選擇權,PUT,外資及陸資,55941,203892,54185,207155,1756,-3263,151176,2928908,78654,1566624,72522,1362284
2015/8/31,臺指選擇權,CALL,自營商,153018,419995,152283,467341,735,-47345,159676,1317857,169847,834413,-10171,483444
2015/8/31,臺指選擇權,CALL,投信,38,228,8,24,30,204,110,1200,308,837,-198,363
2015/8/31,臺指選擇權,CALL,外資及陸資,33708,133429,34967,140299,-1259,-6870,175839,377097,117516,459967,58323,-82870
2015/8/31,臺指選擇權,PUT,自營商,154127,402878,158202,401124,-4075,1754,116778,686818,187044,1695195,-70266,-1008377
2015/8/31,臺指選擇權,PUT,投信,0,0,0,0,0,0,40,496,150,4015,-110,-3519
2015/8/31,臺指選擇權,PUT,外資及陸資,40498,141844,36734,141237,3764,607,154967,2649970,78720,1404687,76247,1245283
2015/9/1,臺指選擇權,CALL,自營商,180243,413072,181655,438572,-1412,-25500,165838,978637,177372,604235,-11534,374402
2015/9/1,臺指選擇權,CALL,投信,20,78,4,5,16,73,126,786,308,496,-182,290
2015/9/1,臺指選擇權,CALL,外資及陸資,48585,176256,50297,175448,-1712,808,176420,265514,119838,346304,56582,-80790
2015/9/1,臺指選擇權,PUT,自營商,196181,504568,199148,542782,-2967,-38214,124297,905402,197661,2170240,-73364,-1264838
2015/9/1,臺指選擇權,PUT,投信,450,914,0,0,450,914,490,1710,150,4552,340,-2842
2015/9/1,臺指選擇權,PUT,外資及陸資,59618,188916,52978,184742,6640,4174,160175,3170923,77271,1667229,82904,1503694
2015/9/2,臺指選擇權,CALL,自營商,277884,625817,272508,634146,5376,-8330,138058,1040831,145159,583722,-7101,457109
2015/9/2,臺指選擇權,CALL,投信,20,157,50,216,-30,-59,60,452,310,444,-250,8
2015/9/2,臺指選擇權,CALL,外資及陸資,50659,199133,48639,194585,2020,4548,172690,309940,119419,399813,53271,-89873
2015/9/2,臺指選擇權,PUT,自營商,277805,543862,289038,536235,-11233,7627,96242,743527,150477,1800219,-54235,-1056692
2015/9/2,臺指選擇權,PUT,投信,0,0,50,345,-50,-345,490,1111,140,4406,350,-3295
2015/9/2,臺指選擇權,PUT,外資及陸資,43396,149919,43713,156732,-317,-6814,152731,2795455,75708,1478112,77023,1317343
2015/9/3,臺指選擇權,CALL,自營商,115398,297591,120327,329875,-4929,-32284,142632,1036419,154816,597128,-12184,439291
2015/9/3,臺指選擇權,CALL,投信,20,143,26,83,-6,60,80,604,336,537,-256,67
2015/9/3,臺指選擇權,CALL,外資及陸資,33301,131847,33966,137859,-665,-6012,175067,306119,122493,410097,52574,-103978
2015/9/3,臺指選擇權,PUT,自營商,128393,333736,116651,304566,11742,29170,117837,698129,160345,1652097,-42508,-953968
2015/9/3,臺指選擇權,PUT,投信,0,0,26,156,-26,-156,490,760,166,4267,324,-3507
2015/9/3,臺指選擇權,PUT,外資及陸資,36035,140341,31737,131562,4298,8780,158988,2622718,77646,1389880,81342,1232838
2015/9/4,臺指選擇權,CALL,自營商,152031,340690,137419,342530,14612,-1841,164348,886226,161906,497338,2442,388888
2015/9/4,臺指選擇權,CALL,投信,46,261,14,29,32,232,126,641,350,312,-224,329
2015/9/4,臺指選擇權,CALL,外資及陸資,32616,129996,29080,110519,3536,19476,179674,252648,123553,339602,56121,-86954
2015/9/4,臺指選擇權,PUT,自營商,136799,365104,147252,434376,-10453,-69271,124080,829982,177060,1959726,-52980,-1129744
2015/9/4,臺指選擇權,PUT,投信,0,0,0,0,0,0,490,1019,166,4722,324,-3703
2015/9/4,臺指選擇權,PUT,外資及陸資,50209,193115,38942,149154,11267,43961,172465,2948109,79855,1536178,92610,1411931
2015/9/7,臺指選擇權,CALL,自營商,148921,302845,142420,323952,6501,-21107,180433,904479,171659,522963,8774,381516
2015/9/7,臺指選擇權,CALL,投信,46,214,0,0,46,214,172,765,350,237,-178,528
2015/9/7,臺指選擇權,CALL,外資及陸資,37276,142063,34620,130363,2656,11700,182492,253559,123742,341160,58750,-87601
2015/9/7,臺指選擇權,PUT,自營商,159369,365096,149582,352548,9787,12548,143537,744639,186694,1772804,-43157,-1028165
2015/9/7,臺指選擇權,PUT,投信,0,0,0,0,0,0,490,658,166,4407,324,-3749
2015/9/7,臺指選擇權,PUT,外資及陸資,44645,151540,42375,148742,2270,2798,176074,2725754,81174,1431172,94900,1294582
2015/9/8,臺指選擇權,CALL,自營商,127779,219863,126382,236595,1397,-16733,188679,935962,178573,558603,10106,377359
2015/9/8,臺指選擇權,CALL,投信,24,120,0,0,24,120,196,976,350,213,-154,763
2015/9/8,臺指選擇權,CALL,外資及陸資,35180,105822,35070,99557,110,6265,184626,254353,125770,350284,58856,-95931
2015/9/8,臺指選擇權,PUT,自營商,154030,287495,146094,274461,7936,13034,156831,659897,192022,1591813,-35191,-931916
2015/9/8,臺指選擇權,PUT,投信,0,0,0,0,0,0,490,475,166,4038,324,-3563
2015/9/8,臺指選擇權,PUT,外資及陸資,44646,120839,39348,116309,5298,4530,181889,2527171,81685,1333648,100204,1193523
2015/9/9,臺指選擇權,CALL,自營商,247085,757541,275550,862307,-28465,-104765,127250,1714624,147887,1061125,-20637,653499
2015/9/9,臺指選擇權,CALL,投信,20,179,50,210,-30,-30,60,882,310,760,-250,122
2015/9/9,臺指選擇權,CALL,外資及陸資,74050,286647,76043,309179,-1993,-22531,179970,718480,124698,757428,55272,-38948
2015/9/9,臺指選擇權,PUT,自營商,265311,451495,309694,395698,-44383,55797,113445,409362,173941,892715,-60496,-483353
2015/9/9,臺指選擇權,PUT,投信,0,0,50,260,-50,-260,490,97,140,2967,350,-2870
2015/9/9,臺指選擇權,PUT,外資及陸資,62645,138269,47039,114384,15606,23886,185896,1567019,76608,827961,109288,739058
2015/9/10,臺指選擇權,CALL,自營商,117325,316589,135615,426248,-18290,-109659,125780,1483694,164550,986905,-38770,496789
2015/9/10,臺指選擇權,CALL,投信,2,13,60,84,-58,-70,62,710,370,654,-308,56
2015/9/10,臺指選擇權,CALL,外資及陸資,45145,172277,49443,189337,-4298,-17060,178995,612579,127860,681082,51135,-68503
2015/9/10,臺指選擇權,PUT,自營商,131747,324819,120039,294582,11708,30237,126238,504848,174806,996782,-48568,-491934
2015/9/10,臺指選擇權,PUT,投信,0,0,14,60,-14,-60,490,101,154,3289,336,-3188
2015/9/10,臺指選擇權,PUT,外資及陸資,58564,169736,43552,143043,15012,26694,206140,1752613,81993,915656,124147,836957
2015/9/11,臺指選擇權,CALL,自營商,107817,275069,98081,287425,9736,-12357,137009,1458621,166076,960319,-29067,498302
2015/9/11,臺指選擇權,CALL,投信,38,235,132,124,-94,111,100,919,502,699,-402,220
2015/9/11,臺指選擇權,CALL,外資及陸資,36636,128406,39104,160045,-2468,-31639,177752,577604,129103,685121,48649,-107517
2015/9/11,臺指選擇權,PUT,自營商,109155,228941,112849,250418,-3694,-21477,133362,496369,185839,1016615,-52477,-520246
2015/9/11,臺指選擇權,PUT,投信,0,0,14,67,-14,-67,490,71,168,3296,322,-3225
2015/9/11,臺指選擇權,PUT,外資及陸資,32175,101255,28469,118725,3706,-17470,212088,1728988,84155,918035,127933,810953
2015/9/14,臺指選擇權,CALL,自營商,135986,263362,143336,333850,-7350,-70488,144651,1442929,181086,986431,-36435,456498
2015/9/14,臺指選擇權,CALL,投信,38,215,8,22,30,192,138,1104,510,674,-372,430
2015/9/14,臺指選擇權,CALL,外資及陸資,48782,137767,46785,145924,1997,-8156,184574,576866,133951,693279,50623,-116413
2015/9/14,臺指選擇權,PUT,自營商,141227,273615,137614,253450,3613,20164,147967,495103,196663,1010808,-48696,-515705
2015/9/14,臺指選擇權,PUT,投信,0,0,0,0,0,0,490,34,168,3184,322,-3150
2015/9/14,臺指選擇權,PUT,外資及陸資,34627,106391,32757,111773,1870,-5382,214842,1703767,85011,916052,129831,787715
2015/9/15,臺指選擇權,CALL,自營商,145294,233786,138201,254279,7093,-20493,147427,1310295,176733,847473,-29306,462822
2015/9/15,臺指選擇權,CALL,投信,96,1440,96,937,0,504,226,2111,598,1247,-372,864
2015/9/15,臺指選擇權,CALL,外資及陸資,46635,119801,39850,110881,6785,8920,188854,499277,131451,611393,57403,-112116
2015/9/15,臺指選擇權,PUT,自營商,118889,216831,133394,248942,-14505,-32111,142497,510321,205674,1100242,-63177,-589921
2015/9/15,臺指選擇權,PUT,投信,118,1396,96,941,22,455,584,1309,240,4150,344,-2841
2015/9/15,臺指選擇權,PUT,外資及陸資,35346,106823,32963,114149,2383,-7327,218018,1808860,85752,983728,132266,825132
2015/9/16,臺指選擇權,CALL,自營商,197860,407254,186615,341399,11245,65856,69551,451047,55922,257148,13629,193899
2015/9/16,臺指選擇權,CALL,投信,8,66,44,197,-36,-131,96,1503,282,1144,-186,359
2015/9/16,臺指選擇權,CALL,外資及陸資,51781,129829,35894,106252,15887,23576,95828,299362,53005,213626,42823,85736
2015/9/16,臺指選擇權,PUT,自營商,167002,278483,192489,281158,-25487,-2675,41099,285880,64185,688690,-23086,-402810
2015/9/16,臺指選擇權,PUT,投信,0,0,44,206,-44,-206,88,1008,132,900,-44,108
2015/9/16,臺指選擇權,PUT,外資及陸資,33678,86328,32119,107528,1559,-21200,63415,1170531,39846,658355,23569,512176
2015/9/17,臺指選擇權,CALL,自營商,115879,385539,105407,383971,10472,1568,91205,631748,67123,375670,24082,256078
2015/9/17,臺指選擇權,CALL,投信,72,138,32,74,40,64,118,2102,264,1792,-146,310
2015/9/17,臺指選擇權,CALL,外資及陸資,42368,151075,29580,132276,12788,18799,108294,405487,52670,262530,55624,142957
2015/9/17,臺指選擇權,PUT,自營商,125510,346251,125111,358836,399,-12585,64487,273895,87206,604567,-22719,-330672
2015/9/17,臺指選擇權,PUT,投信,0,0,22,143,-22,-143,88,638,154,639,-66,-1
2015/9/17,臺指選擇權,PUT,外資及陸資,40639,133348,31163,113771,9476,19577,76000,970980,42954,534390,33046,436590
2015/9/18,臺指選擇權,CALL,自營商,81308,219250,88283,266682,-6975,-47431,90665,540650,73575,360454,17090,180196
2015/9/18,臺指選擇權,CALL,投信,106,525,216,743,-110,-218,224,2476,480,2226,-256,250
2015/9/18,臺指選擇權,CALL,外資及陸資,24538,86240,25873,94898,-1335,-8659,107633,332208,53370,233832,54263,98376
2015/9/18,臺指選擇權,PUT,自營商,120808,247098,113292,232639,7516,14459,76374,247761,91559,521689,-15185,-273928
2015/9/18,臺指選擇權,PUT,投信,2,9,2,3,0,6,90,532,156,421,-66,111
2015/9/18,臺指選擇權,PUT,外資及陸資,32723,93481,24185,80240,8538,13241,85273,891105,43673,476400,41600,414705
2015/9/21,臺指選擇權,CALL,自營商,134809,274513,134906,288066,-97,-13553,106184,399186,89198,268535,16986,130651
2015/9/21,臺指選擇權,CALL,投信,18,113,48,52,-30,60,232,1672,518,1248,-286,424
2015/9/21,臺指選擇權,CALL,外資及陸資,33706,101430,33066,97820,640,3610,111142,233496,56212,183010,54930,50486
2015/9/21,臺指選擇權,PUT,自營商,149823,407656,150491,428596,-668,-20941,94190,405599,110105,762169,-15915,-356570
2015/9/21,臺指選擇權,PUT,投信,10,56,10,51,0,5,90,883,156,881,-66,2
2015/9/21,臺指選擇權,PUT,外資及陸資,46986,188326,41515,169932,5471,18394,93488,1150036,46406,616714,47082,533322
2015/9/22,臺指選擇權,CALL,自營商,85108,171967,79969,159619,5139,12348,115029,452446,92877,308302,22152,144144
2015/9/22,臺指選擇權,CALL,投信,34,110,20,25,14,86,256,1975,528,1380,-272,595
2015/9/22,臺指選擇權,CALL,外資及陸資,21661,71884,20263,70237,1398,1647,114330,255315,57983,201723,56347,53592
2015/9/22,臺指選擇權,PUT,自營商,94557,175227,101689,193260,-7132,-18033,99746,343653,122748,667711,-23002,-324058
2015/9/22,臺指選擇權,PUT,投信,0,0,0,0,0,0,90,675,156,588,-66,87
2015/9/22,臺指選擇權,PUT,外資及陸資,24301,67491,22438,83684,1863,-16193,98478,1028621,49477,567984,49001,460637
2015/9/23,臺指選擇權,CALL,自營商,204610,330732,231190,349403,-26580,-18671,91860,324451,80600,194570,11260,129881
2015/9/23,臺指選擇權,CALL,投信,20,142,50,166,-30,-24,208,1131,488,786,-280,345
2015/9/23,臺指選擇權,CALL,外資及陸資,31154,82971,26454,70656,4700,12316,112970,177830,56005,136110,56965,41720
2015/9/23,臺指選擇權,PUT,自營商,212149,502393,225592,581481,-13443,-79088,70632,477120,105196,890789,-34564,-413669
2015/9/23,臺指選擇權,PUT,投信,0,0,50,230,-50,-230,88,1135,138,968,-50,167
2015/9/23,臺指選擇權,PUT,外資及陸資,43482,150194,35885,141327,7597,8867,90601,1330245,49160,734336,41441,595909
2015/9/24,臺指選擇權,CALL,自營商,140972,334310,143420,350947,-2448,-16637,112972,337975,104158,228110,8814,109865
2015/9/24,臺指選擇權,CALL,投信,20,122,14,30,6,92,228,1052,502,631,-274,421
2015/9/24,臺指選擇權,CALL,外資及陸資,36113,126515,36865,132859,-752,-6344,118433,176306,62215,145817,56218,30489
2015/9/24,臺指選擇權,PUT,自營商,157434,483235,155061,494943,2373,-11708,91186,570042,123102,1030128,-31916,-460086
2015/9/24,臺指選擇權,PUT,投信,0,0,14,74,-14,-74,88,1280,152,1181,-64,99
2015/9/24,臺指選擇權,PUT,外資及陸資,49018,185603,41095,185407,7923,196,102531,1432862,53147,802564,49384,630298
2015/9/25,臺指選擇權,CALL,自營商,119231,307009,118346,325143,885,-18134,128410,390632,118764,293328,9646,97304
2015/9/25,臺指選擇權,CALL,投信,46,290,14,29,32,260,274,1433,516,705,-242,728
2015/9/25,臺指選擇權,CALL,外資及陸資,31241,109376,32225,112173,-984,-2797,119829,192361,64549,160066,55280,32295
2015/9/25,臺指選擇權,PUT,自營商,144761,446710,145942,440752,-1181,5958,99133,544560,132249,972682,-33116,-428122
2015/9/25,臺指選擇權,PUT,投信,0,0,14,64,-14,-64,88,1166,166,1108,-78,58
2015/9/25,臺指選擇權,PUT,外資及陸資,51616,173724,42019,163503,9597,10221,113952,1387515,54971,773022,58981,614493
2015/9/30,臺指選擇權,CALL,自營商,206355,419949,205463,411566,892,8383,101981,390136,103170,269738,-1189,120398
2015/9/30,臺指選擇權,CALL,投信,20,125,38,114,-18,11,208,1018,476,663,-268,355
2015/9/30,臺指選擇權,CALL,外資及陸資,42807,135471,37569,118137,5238,17333,117780,201356,61236,146685,56544,54671
2015/9/30,臺指選擇權,PUT,自營商,213511,423936,221658,469808,-8147,-45873,81273,465824,114771,883996,-33498,-418172
2015/9/30,臺指選擇權,PUT,投信,0,0,38,186,-38,-186,88,1113,126,843,-38,270
2015/9/30,臺指選擇權,PUT,外資及陸資,55353,199115,42240,146423,13113,52692,114256,1406832,55997,762929,58259,643903
2015/10/1,臺指選擇權,CALL,自營商,139986,413100,140708,459493,-722,-46392,109612,577162,111529,469515,-1917,107647
2015/10/1,臺指選擇權,CALL,投信,70,136,14,24,56,112,228,1763,440,1221,-212,542
2015/10/1,臺指選擇權,CALL,外資及陸資,48250,205686,43132,174805,5118,30881,124403,337891,62727,203497,61676,134394
2015/10/1,臺指選擇權,PUT,自營商,186868,402621,193314,437296,-6446,-34674,99372,338837,139312,667637,-39940,-328800
2015/10/1,臺指選擇權,PUT,投信,0,0,14,66,-14,-66,88,616,140,438,-52,178
2015/10/1,臺指選擇權,PUT,外資及陸資,55837,175542,45791,154263,10046,21278,126306,1102299,57963,594473,68343,507826
2015/10/2,臺指選擇權,CALL,自營商,81520,194353,81021,205039,499,-10686,107863,509217,109227,414980,-1364,94237
2015/10/2,臺指選擇權,CALL,投信,38,177,22,31,16,145,266,1726,462,1074,-196,652
2015/10/2,臺指選擇權,CALL,外資及陸資,20749,67158,20655,68239,94,-1081,125608,306761,63836,190816,61772,115945
2015/10/2,臺指選擇權,PUT,自營商,97642,186642,102092,204628,-4450,-17986,105202,362656,149634,713912,-44432,-351256
2015/10/2,臺指選擇權,PUT,投信,0,0,14,69,-14,-69,88,669,154,535,-66,134
2015/10/2,臺指選擇權,PUT,外資及陸資,27685,65997,20389,66116,7296,-120,134173,1130022,58526,610040,75647,519982
2015/10/5,臺指選擇權,CALL,自營商,124013,254328,123527,267613,486,-13286,116229,540980,117196,460532,-967,80448
2015/10/5,臺指選擇權,CALL,投信,58,173,68,60,-10,113,304,2082,510,1196,-206,886
2015/10/5,臺指選擇權,CALL,外資及陸資,34655,104018,34119,115525,536,-11507,128775,325788,66390,212405,62385,113383
2015/10/5,臺指選擇權,PUT,自營商,134910,233479,143951,213005,-9041,20474,99430,304761,153550,588332,-54120,-283571
2015/10/5,臺指選擇權,PUT,投信,10,45,10,48,0,-3,88,471,154,298,-66,173
2015/10/5,臺指選擇權,PUT,外資及陸資,34962,88184,28443,85490,6519,2695,141007,990642,58904,538398,82103,452244
2015/10/6,臺指選擇權,CALL,自營商,160009,345258,158040,329558,1969,15700,126235,581124,124038,490148,2197,90976
2015/10/6,臺指選擇權,CALL,投信,60,101,4,2,56,99,324,2402,474,1298,-150,1104
2015/10/6,臺指選擇權,CALL,外資及陸資,45301,137749,38293,126641,7008,11108,135556,358048,66064,226244,69492,131804
2015/10/6,臺指選擇權,PUT,自營商,169936,247963,197029,257286,-27093,-9323,102230,289966,183502,569578,-81272,-279612
2015/10/6,臺指選擇權,PUT,投信,0,0,0,0,0,0,88,374,154,196,-66,178
2015/10/6,臺指選擇權,PUT,外資及陸資,48038,95352,32857,86109,15181,9243,154428,936483,57156,501545,97272,434938
2015/10/7,臺指選擇權,CALL,自營商,193518,349007,191375,344254,2143,4753,91915,640829,108253,486562,-16338,154267
2015/10/7,臺指選擇權,CALL,投信,27,140,133,165,-106,-24,215,2206,521,1570,-306,636
2015/10/7,臺指選擇權,CALL,外資及陸資,37214,101826,36011,106356,1203,-4530,132375,456379,65316,276647,67059,179732
2015/10/7,臺指選擇權,PUT,自營商,197893,244488,217144,256018,-19251,-11531,75074,222371,153861,445745,-78787,-223374
2015/10/7,臺指選擇權,PUT,投信,0,0,73,300,-73,-300,88,183,161,379,-73,-196
2015/10/7,臺指選擇權,PUT,外資及陸資,35035,70636,27793,67458,7242,3178,145842,775085,55417,418723,90425,356362
2015/10/8,臺指選擇權,CALL,自營商,165809,345898,164394,344497,1415,1401,101024,572695,115852,411881,-14828,160814
2015/10/8,臺指選擇權,CALL,投信,111,371,67,310,44,61,266,2158,528,1464,-262,694
2015/10/8,臺指選擇權,CALL,外資及陸資,43784,130215,41014,157794,2770,-27579,137847,367799,67901,248611,69946,119188
2015/10/8,臺指選擇權,PUT,自營商,159587,285294,157676,281876,1911,3417,90255,292548,167179,523276,-76924,-230728
2015/10/8,臺指選擇權,PUT,投信,24,202,67,433,-43,-231,112,421,228,907,-116,-486
2015/10/8,臺指選擇權,PUT,外資及陸資,47510,107842,32021,97563,15489,10279,159700,844842,53820,452189,105880,392653
2015/10/12,臺指選擇權,CALL,自營商,162314,346150,155712,348279,6602,-2129,111753,738857,119970,554975,-8217,183882
2015/10/12,臺指選擇權,CALL,投信,48,142,12,9,36,133,314,3121,540,2237,-226,884
2015/10/12,臺指選擇權,CALL,外資及陸資,42172,135452,37283,120743,4889,14709,144349,505381,69489,313282,74860,192099
2015/10/12,臺指選擇權,PUT,自營商,181246,248094,202742,265042,-21496,-16948,99325,228247,197791,442051,-98466,-213804
2015/10/12,臺指選擇權,PUT,投信,0,0,0,0,0,0,112,235,228,386,-116,-151
2015/10/12,臺指選擇權,PUT,外資及陸資,38393,77756,32788,73404,5605,4352,167598,705636,56124,381964,111474,323672
2015/10/13,臺指選擇權,CALL,自營商,111004,196068,115230,240483,-4226,-44415,112919,708970,125274,567858,-12355,141112
2015/10/13,臺指選擇權,CALL,投信,43,265,28,218,15,47,357,3334,568,2344,-211,990
2015/10/13,臺指選擇權,CALL,外資及陸資,22297,62671,26853,81467,-4556,-18796,140937,488156,70740,318003,70197,170153
2015/10/13,臺指選擇權,PUT,自營商,139478,179834,132562,182607,6916,-2773,108677,220945,200261,432624,-91584,-211679
2015/10/13,臺指選擇權,PUT,投信,16,90,16,119,0,-28,128,292,244,410,-116,-118
2015/10/13,臺指選擇權,PUT,外資及陸資,23474,55545,22206,48695,1268,6851,169131,688012,56364,369979,112767,318033
2015/10/14,臺指選擇權,CALL,自營商,153191,232521,151455,235612,1736,-3091,89152,620079,102756,457922,-13604,162157
2015/10/14,臺指選擇權,CALL,投信,7,41,63,143,-56,-102,235,2429,491,1964,-256,465
2015/10/14,臺指選擇權,CALL,外資及陸資,26059,71621,27022,105526,-963,-33905,135176,378845,69141,282385,66035,96460
2015/10/14,臺指選擇權,PUT,自營商,171809,222326,178302,225857,-6493,-3531,83932,226747,180142,437355,-96210,-210608
2015/10/14,臺指選擇權,PUT,投信,0,0,63,203,-63,-203,128,316,191,555,-63,-239
2015/10/14,臺指選擇權,PUT,外資及陸資,26707,60407,26463,53923,244,6484,157058,715119,53771,376010,103287,339109
2015/10/15,臺指選擇權,CALL,自營商,153410,386591,148321,381158,5089,5433,96224,755293,104746,566259,-8522,189034
2015/10/15,臺指選擇權,CALL,投信,27,131,43,51,-16,80,262,3208,534,2740,-272,468
2015/10/15,臺指選擇權,CALL,外資及陸資,49597,179382,39186,159266,10411,20115,145933,499869,69474,339109,76459,160760
2015/10/15,臺指選擇權,PUT,自營商,169807,256811,185159,256983,-15352,-172,93060,204210,204768,407580,-111708,-203370
2015/10/15,臺指選擇權,PUT,投信,0,0,43,174,-43,-174,128,214,234,522,-106,-308
2015/10/15,臺指選擇權,PUT,外資及陸資,39491,92016,31339,89012,8152,3003,167528,647407,56055,346727,111473,300680
2015/10/16,臺指選擇權,CALL,自營商,86817,142088,99826,187958,-13009,-45870,96270,728033,117623,587658,-21353,140375
2015/10/16,臺指選擇權,CALL,投信,24,280,47,270,-23,9,278,3306,573,2835,-295,471
2015/10/16,臺指選擇權,CALL,外資及陸資,23598,67000,20353,62256,3245,4744,148978,493631,69270,336021,79708,157610
2015/10/16,臺指選擇權,PUT,自營商,108862,146866,108195,136636,667,10230,98969,206213,210048,401386,-111079,-195173
2015/10/16,臺指選擇權,PUT,投信,44,239,31,114,13,125,172,433,265,578,-93,-145
2015/10/16,臺指選擇權,PUT,外資及陸資,23250,61014,20885,56842,2365,4172,171159,642744,57317,346031,113842,296713
2015/10/19,臺指選擇權,CALL,自營商,105511,176255,107531,216212,-2020,-39958,103282,742777,126647,636372,-23365,106405
2015/10/19,臺指選擇權,CALL,投信,12,55,12,18,0,37,290,3472,585,2966,-295,506
2015/10/19,臺指選擇權,CALL,外資及陸資,30474,85549,30760,88417,-286,-2868,149328,511711,69930,350977,79398,160734
2015/10/19,臺指選擇權,PUT,自營商,137600,152667,126777,147991,10823,4676,125289,208413,225615,398696,-100326,-190283
2015/10/19,臺指選擇權,PUT,投信,36,102,0,0,36,102,208,470,265,468,-57,2
2015/10/19,臺指選擇權,PUT,外資及陸資,22778,51095,23145,59095,-367,-8000,172216,613538,58713,339087,113503,274451
2015/10/20,臺指選擇權,CALL,自營商,81543,150087,76999,143115,4544,6972,102267,785088,120992,674722,-18725,110366
2015/10/20,臺指選擇權,CALL,投信,20,137,20,78,0,59,310,3944,605,3372,-295,572
2015/10/20,臺指選擇權,CALL,外資及陸資,28707,89555,24163,90802,4544,-1246,154494,560910,70546,384811,83948,176099
2015/10/20,臺指選擇權,PUT,自營商,94392,109794,113353,114724,-18961,-4930,118106,167160,237296,356578,-119190,-189418
2015/10/20,臺指選擇權,PUT,投信,8,52,8,39,0,13,216,357,273,351,-57,6
2015/10/20,臺指選擇權,PUT,外資及陸資,14671,34702,14397,34047,274,655,173643,571805,59866,318474,113777,253331
2015/10/21,臺指選擇權,CALL,自營商,161566,271648,168293,286047,-6727,-14399,40211,268525,46820,150318,-6609,118207
2015/10/21,臺指選擇權,CALL,投信,212,447,58,110,154,337,76,737,122,852,-46,-115
2015/10/21,臺指選擇權,CALL,外資及陸資,25947,64856,19373,60487,6574,4369,107111,307015,55441,213529,51670,93486
2015/10/21,臺指選擇權,PUT,自營商,175072,291982,185730,288104,-10658,3877,40150,147548,59023,349689,-18873,-202141
2015/10/21,臺指選擇權,PUT,投信,0,0,58,205,-58,-205,64,308,122,531,-58,-223
2015/10/21,臺指選擇權,PUT,外資及陸資,24003,63613,20829,60774,3174,2838,68488,603873,41122,336613,27366,267260
2015/10/22,臺指選擇權,CALL,自營商,74645,149319,65051,143595,9594,5724,56405,282430,53468,162434,2937,119996
2015/10/22,臺指選擇權,CALL,投信,41,324,57,199,-16,125,117,999,179,969,-62,30
2015/10/22,臺指選擇權,CALL,外資及陸資,21052,68109,17527,56209,3525,11900,110754,303666,55562,207214,55192,96452
2015/10/22,臺指選擇權,PUT,自營商,74076,124798,74897,160896,-821,-36097,53239,150865,73060,386700,-19821,-235835
2015/10/22,臺指選擇權,PUT,投信,24,162,57,257,-33,-94,88,479,179,789,-91,-310
2015/10/22,臺指選擇權,PUT,外資及陸資,20019,54559,17147,56054,2872,-1496,72677,612020,42457,345442,30220,266578
2015/10/23,臺指選擇權,CALL,自營商,121762,255661,121082,288776,680,-33115,66223,350256,62547,233213,3676,117043
2015/10/23,臺指選擇權,CALL,投信,48,173,35,24,13,149,165,1528,214,1381,-49,147
2015/10/23,臺指選擇權,CALL,外資及陸資,25376,87230,23754,86519,1622,711,112881,369134,56013,243249,56868,125885
2015/10/23,臺指選擇權,PUT,自營商,131770,232053,130434,214374,1336,17679,65472,152600,83917,321835,-18445,-169235
2015/10/23,臺指選擇權,PUT,投信,0,0,23,91,-23,-91,88,294,202,472,-114,-178
2015/10/23,臺指選擇權,PUT,外資及陸資,27233,68231,20629,61873,6604,6357,79248,519849,42400,288449,36848,231400
2015/10/26,臺指選擇權,CALL,自營商,84970,174053,85575,169116,-605,4937,69319,388149,66055,263005,3264,125144
2015/10/26,臺指選擇權,CALL,投信,48,149,12,8,36,141,213,1862,226,1566,-13,296
2015/10/26,臺指選擇權,CALL,外資及陸資,22384,63208,18327,60886,4057,2322,119102,402634,58123,264373,60979,138261
2015/10/26,臺指選擇權,PUT,自營商,88361,131364,88509,134935,-148,-3571,75755,137887,94337,297780,-18582,-159893
2015/10/26,臺指選擇權,PUT,投信,0,0,0,0,0,0,88,208,202,270,-114,-62
2015/10/26,臺指選擇權,PUT,外資及陸資,21473,51550,16673,41914,4800,9636,84669,477839,43078,259998,41591,217841
2015/10/27,臺指選擇權,CALL,自營商,120890,172077,127434,204609,-6544,-32532,76001,348578,79276,251728,-3275,96850
2015/10/27,臺指選擇權,CALL,投信,27,69,17,7,10,62,240,1552,243,1230,-3,322
2015/10/27,臺指選擇權,CALL,外資及陸資,22778,58343,19982,57847,2796,496,123949,363790,60193,247127,63756,116663
2015/10/27,臺指選擇權,PUT,自營商,131267,204371,127389,188669,3878,15702,89605,178552,104445,331158,-14840,-152606
2015/10/27,臺指選擇權,PUT,投信,5,14,0,0,5,14,93,252,202,298,-109,-46
2015/10/27,臺指選擇權,PUT,外資及陸資,25725,60799,19368,54324,6357,6474,91811,519389,43839,282552,47972,236837
2015/10/28,臺指選擇權,CALL,自營商,168722,230232,177225,237359,-8503,-7127,50586,282084,67777,189267,-17191,92817
2015/10/28,臺指選擇權,CALL,投信,12,58,58,93,-46,-35,100,937,146,944,-46,-7
2015/10/28,臺指選擇權,CALL,外資及陸資,23885,64768,20887,56490,2998,8278,125421,322899,59684,222027,65737,100872
2015/10/28,臺指選擇權,PUT,自營商,185119,294460,192584,285304,-7465,9157,65608,205210,83899,353835,-18291,-148625
2015/10/28,臺指選擇權,PUT,投信,0,0,58,206,-58,-206,88,306,146,496,-58,-190
2015/10/28,臺指選擇權,PUT,外資及陸資,31546,77760,26722,70214,4824,7546,85593,581033,44183,311966,41410,269067
2015/10/29,臺指選擇權,CALL,自營商,153376,250996,160475,273971,-7099,-22975,65801,246970,90147,167106,-24346,79864
2015/10/29,臺指選擇權,CALL,投信,20,55,20,66,0,-11,100,634,146,636,-46,-2
2015/10/29,臺指選擇權,CALL,外資及陸資,35264,81677,26779,77798,8485,3879,135145,256287,60913,182928,74232,73359
2015/10/29,臺指選擇權,PUT,自營商,151812,321322,151229,330943,583,-9621,77894,291769,95705,465103,-17811,-173334
2015/10/29,臺指選擇權,PUT,投信,0,0,0,0,0,0,88,452,146,774,-58,-322
2015/10/29,臺指選擇權,PUT,外資及陸資,40428,99312,27050,94358,13378,4955,100630,690252,45800,368773,54830,321479
2015/10/30,臺指選擇權,CALL,自營商,174951,296797,181973,295232,-7022,1564,66381,266905,97954,178025,-31573,88880
2015/10/30,臺指選擇權,CALL,投信,44,190,15,8,29,182,144,857,161,670,-17,187
2015/10/30,臺指選擇權,CALL,外資及陸資,36205,95737,34404,91087,1801,4650,140538,275441,64501,195111,76037,80330
2015/10/30,臺指選擇權,PUT,自營商,178308,359113,183302,345081,-4994,14032,80410,268158,103182,430581,-22772,-162423
2015/10/30,臺指選擇權,PUT,投信,0,0,13,32,-13,-32,88,373,159,698,-71,-325
2015/10/30,臺指選擇權,PUT,外資及陸資,42788,108198,33926,111430,8862,-3232,109941,651423,46214,354699,63727,296724
2015/11/2,臺指選擇權,CALL,自營商,120379,208270,123889,213564,-3510,-5294,74921,301404,110261,220829,-35340,80575
2015/11/2,臺指選擇權,CALL,投信,48,169,0,0,48,169,192,1095,161,704,31,391
2015/11/2,臺指選擇權,CALL,外資及陸資,24254,65625,24437,67189,-183,-1565,140999,293727,65186,208262,75813,85465
2015/11/2,臺指選擇權,PUT,自營商,125263,226665,129371,234178,-4108,-7513,88251,258741,115073,421716,-26822,-162975
2015/11/2,臺指選擇權,PUT,投信,6,21,0,0,6,21,94,364,159,581,-65,-217
2015/11/2,臺指選擇權,PUT,外資及陸資,29643,74882,29512,79672,131,-4790,110790,632289,46899,349001,63891,283288
2015/11/3,臺指選擇權,CALL,自營商,169747,379279,158878,326883,10869,52396,80822,456221,105149,300919,-24327,155302
2015/11/3,臺指選擇權,CALL,投信,15,54,12,6,3,48,207,2090,173,1186,34,904
2015/11/3,臺指選擇權,CALL,外資及陸資,35573,124186,33770,117497,1803,6689,142950,422246,65224,272303,77726,149943
2015/11/3,臺指選擇權,PUT,自營商,162454,215529,177648,202376,-15194,13153,99565,186431,141531,311393,-41966,-124962
2015/11/3,臺指選擇權,PUT,投信,6,13,0,0,6,13,100,151,159,141,-59,10
2015/11/3,臺指選擇權,PUT,外資及陸資,30671,61909,23985,52580,6686,9330,118567,507286,48024,279445,70543,227841
2015/11/4,臺指選擇權,CALL,自營商,319324,729006,326966,803217,-7642,-74210,59080,536453,82978,444805,-23898,91648
2015/11/4,臺指選擇權,CALL,投信,27,167,73,199,-46,-32,115,1894,161,1920,-46,-26
2015/11/4,臺指選擇權,CALL,外資及陸資,65434,237014,71123,277211,-5689,-40197,134257,687718,72050,419655,62207,268063
2015/11/4,臺指選擇權,PUT,自營商,276045,359682,289879,349877,-13834,9806,80748,166018,114248,277704,-33500,-111686
2015/11/4,臺指選擇權,PUT,投信,0,0,73,291,-73,-291,88,77,161,358,-73,-281
2015/11/4,臺指選擇權,PUT,外資及陸資,42909,95343,36457,86760,6452,8584,111535,428845,49055,234680,62480,194165
2015/11/5,臺指選擇權,CALL,自營商,121044,249830,124290,275880,-3246,-26050,71900,544500,99072,480386,-27172,64114
2015/11/5,臺指選擇權,CALL,投信,17,97,38,79,-21,18,132,1956,199,1949,-67,7
2015/11/5,臺指選擇權,CALL,外資及陸資,25937,90758,27785,105397,-1848,-14638,135746,698126,75307,436817,60439,261309
2015/11/5,臺指選擇權,PUT,自營商,129656,211779,119442,201273,10214,10507,101286,203009,124652,307494,-23366,-104485
2015/11/5,臺指選擇權,PUT,投信,0,0,38,161,-38,-161,88,74,199,531,-111,-457
2015/11/5,臺指選擇權,PUT,外資及陸資,22943,66317,17772,54816,5171,11501,117488,453240,49846,243284,67642,209956
2015/11/6,臺指選擇權,CALL,自營商,286292,597367,302772,660368,-16480,-63001,90142,413502,133838,374439,-43696,39063
2015/11/6,臺指選擇權,CALL,投信,0,0,23,57,-23,-57,132,1093,222,1162,-90,-69
2015/11/6,臺指選擇權,CALL,外資及陸資,54376,158387,47223,148803,7153,9584,145578,466559,77952,309586,67626,156973
2015/11/6,臺指選擇權,PUT,自營商,288928,731759,294923,768825,-5995,-37065,127876,504440,157234,616677,-29358,-112237
2015/11/6,臺指選擇權,PUT,投信,28,179,15,35,13,145,116,384,214,1411,-98,-1027
2015/11/6,臺指選擇權,PUT,外資及陸資,52728,190115,51332,216752,1396,-26637,121957,643789,52928,363604,69029,280185
2015/11/9,臺指選擇權,CALL,自營商,258456,469210,281739,442492,-23283,26718,96648,342832,163570,245160,-66922,97672
2015/11/9,臺指選擇權,CALL,投信,36,117,12,11,24,106,168,874,234,788,-66,86
2015/11/9,臺指選擇權,CALL,外資及陸資,54628,153486,56232,153362,-1604,125,145436,364124,79554,260927,65882,103197
2015/11/9,臺指選擇權,PUT,自營商,286205,654506,293312,577090,-7107,77417,122781,545733,159322,596364,-36541,-50631
2015/11/9,臺指選擇權,PUT,投信,12,50,0,0,12,50,128,442,214,1568,-86,-1126
2015/11/9,臺指選擇權,PUT,外資及陸資,59232,195354,63009,220783,-3777,-25429,122160,707336,56768,424404,65392,282932
2015/11/10,臺指選擇權,CALL,自營商,208940,282271,231237,318450,-22297,-36179,106795,274663,196035,213748,-89240,60915
2015/11/10,臺指選擇權,CALL,投信,12,38,0,0,12,38,180,521,234,493,-54,28
2015/11/10,臺指選擇權,CALL,外資及陸資,37382,100000,35929,85088,1453,14913,149464,304470,82141,217155,67323,87315
2015/11/10,臺指選擇權,PUT,自營商,223219,476992,222494,538902,725,-61910,134372,759574,170155,829024,-35783,-69450
2015/11/10,臺指選擇權,PUT,投信,27,95,0,0,27,95,155,844,214,2237,-59,-1393
2015/11/10,臺指選擇權,PUT,外資及陸資,51510,158809,55027,177968,-3517,-19159,122807,844538,60915,517967,61892,326571
2015/11/11,臺指選擇權,CALL,自營商,341272,487020,383388,550535,-42116,-63514,69028,215634,139335,189296,-70307,26338
2015/11/11,臺指選擇權,CALL,投信,0,0,53,251,-53,-251,88,213,141,460,-53,-247
2015/11/11,臺指選擇權,CALL,外資及陸資,44229,97899,50954,120187,-6725,-22288,149741,233898,90005,185229,59736,48669
2015/11/11,臺指選擇權,PUT,自營商,323999,743107,318849,763951,5150,-20844,95357,746758,123664,811427,-28307,-64669
2015/11/11,臺指選擇權,PUT,投信,127,327,53,208,74,119,215,1186,141,983,74,203
2015/11/11,臺指選擇權,PUT,外資及陸資,66587,221310,67098,253573,-511,-32264,118977,1111681,60809,692466,58168,419215
2015/11/12,臺指選擇權,CALL,自營商,153568,310669,163952,355100,-10384,-44431,72961,240977,153711,274275,-80750,-33298
2015/11/12,臺指選擇權,CALL,投信,0,0,23,129,-23,-129,88,282,164,740,-76,-458
2015/11/12,臺指選擇權,CALL,外資及陸資,35623,104614,36842,114799,-1219,-10184,154406,264787,95938,224005,58468,40782
2015/11/12,臺指選擇權,PUT,自營商,168010,389221,151752,379959,16258,9262,108310,570719,120324,652857,-12014,-82138
2015/11/12,臺指選擇權,PUT,投信,27,142,23,44,4,98,242,824,164,616,78,208
2015/11/12,臺指選擇權,PUT,外資及陸資,42546,147145,42499,165121,47,-17977,118771,915052,60474,593807,58297,321245
2015/11/13,臺指選擇權,CALL,自營商,199754,403790,207140,408286,-7386,-4496,73837,203215,161978,172876,-88141,30339
2015/11/13,臺指選擇權,CALL,投信,0,0,11,50,-11,-50,88,99,175,385,-87,-286
2015/11/13,臺指選擇權,CALL,外資及陸資,48945,141973,47833,140478,1112,1495,158231,219282,98641,181408,59590,37874
2015/11/13,臺指選擇權,PUT,自營商,188866,490492,192891,551940,-4025,-61448,110861,738959,126944,848923,-16083,-109964
2015/11/13,臺指選擇權,PUT,投信,48,263,23,44,25,219,290,1527,187,1050,103,477
2015/11/13,臺指選擇權,PUT,外資及陸資,58650,204726,49859,203741,8791,986,127739,1099012,60654,707947,67085,391065
2015/11/16,臺指選擇權,CALL,自營商,166491,306857,185318,334255,-18827,-27398,73181,167830,180220,139437,-107039,28393
2015/11/16,臺指選擇權,CALL,投信,12,46,0,0,12,46,100,71,175,129,-75,-58
2015/11/16,臺指選擇權,CALL,外資及陸資,43958,115676,42247,116538,1711,-863,160623,182417,99333,150145,61290,32272
2015/11/16,臺指選擇權,PUT,自營商,194816,517917,184884,548944,9932,-31027,112086,782674,118185,901165,-6099,-118491
2015/11/16,臺指選擇權,PUT,投信,48,221,0,0,48,221,338,2166,187,1350,151,816
2015/11/16,臺指選擇權,PUT,外資及陸資,53783,187405,56423,191018,-2640,-3613,125784,1188847,61378,761493,64406,427354
2015/11/17,臺指選擇權,CALL,自營商,242594,529632,223278,450486,19316,79147,79706,255288,167465,195328,-87759,59960
2015/11/17,臺指選擇權,CALL,投信,60,481,48,347,12,133,160,635,223,753,-63,-118
2015/11/17,臺指選擇權,CALL,外資及陸資,62331,206716,64202,208965,-1871,-2250,161293,260707,101890,210527,59403,50180
2015/11/17,臺指選擇權,PUT,自營商,222012,353581,234079,332155,-12067,21426,115305,494468,133482,636270,-18177,-141802
2015/11/17,臺指選擇權,PUT,投信,60,506,48,378,12,128,398,1167,235,750,163,417
2015/11/17,臺指選擇權,PUT,外資及陸資,54167,131506,53556,127048,611,4458,125695,896576,60655,579103,65040,317473
2015/11/18,臺指選擇權,CALL,自營商,208107,278365,243281,312014,-35174,-33649,38474,133559,57022,72470,-18548,61089
2015/11/18,臺指選擇權,CALL,投信,16,117,46,182,-30,-65,64,352,94,329,-30,23
2015/11/18,臺指選擇權,CALL,外資及陸資,35379,83650,34001,85390,1378,-1739,113504,150932,80881,134232,32623,16700
2015/11/18,臺指選擇權,PUT,自營商,207605,403313,223875,460591,-16270,-57278,47312,301949,57083,516477,-9771,-214528
2015/11/18,臺指選擇權,PUT,投信,16,200,46,274,-30,-74,64,944,94,873,-30,71
2015/11/18,臺指選擇權,PUT,外資及陸資,41577,141224,42074,152752,-497,-11529,70690,1007511,53368,696069,17322,311442
2015/11/19,臺指選擇權,CALL,自營商,149321,329812,149303,364101,18,-34289,50695,217063,69315,182068,-18620,34995
2015/11/19,臺指選擇權,CALL,投信,22,161,18,45,4,116,86,723,112,653,-26,70
2015/11/19,臺指選擇權,CALL,外資及陸資,39719,147749,34891,131275,4828,16474,118781,240661,81314,200486,37467,40175
2015/11/19,臺指選擇權,PUT,自營商,158882,341422,159857,367295,-975,-25873,64971,223736,75716,418035,-10745,-194299
2015/11/19,臺指選擇權,PUT,投信,0,0,18,53,-18,-53,64,570,112,509,-48,61
2015/11/19,臺指選擇權,PUT,外資及陸資,39642,148124,30907,112529,8735,35595,78287,807633,52207,525823,26080,281810
2015/11/20,臺指選擇權,CALL,自營商,122806,256443,129847,272610,-7041,-16167,57027,227447,82655,210501,-25628,16946
2015/11/20,臺指選擇權,CALL,投信,48,233,35,55,13,177,134,915,147,659,-13,256
2015/11/20,臺指選擇權,CALL,外資及陸資,27861,94180,25951,91574,1910,2606,122544,250554,83167,210013,39377,40541
2015/11/20,臺指選擇權,PUT,自營商,132760,257721,135905,247390,-3145,10330,74164,241218,88099,421445,-13935,-180227
2015/11/20,臺指選擇權,PUT,投信,0,0,23,104,-23,-104,64,547,135,578,-71,-31
2015/11/20,臺指選擇權,PUT,外資及陸資,28207,79822,27105,81518,1102,-1696,80720,803894,53537,526726,27183,277168
2015/11/23,臺指選擇權,CALL,自營商,128868,264549,125110,252257,3758,12292,68174,265042,90035,245305,-21861,19737
2015/11/23,臺指選擇權,CALL,投信,48,173,12,13,36,160,182,1189,159,737,23,452
2015/11/23,臺指選擇權,CALL,外資及陸資,31534,81324,30173,88193,1361,-6870,124962,257894,84192,225391,40770,32503
2015/11/23,臺指選擇權,PUT,自營商,143647,251186,139741,262442,3906,-11256,92989,227178,103084,399841,-10095,-172663
2015/11/23,臺指選擇權,PUT,投信,0,0,0,0,0,0,64,467,135,422,-71,45
2015/11/23,臺指選擇權,PUT,外資及陸資,29192,76153,28133,79728,1059,-3575,83067,742016,54835,487798,28232,254218
2015/11/24,臺指選擇權,CALL,自營商,202140,357377,195350,320188,6790,37189,83563,234968,98546,165000,-14983,69968
2015/11/24,臺指選擇權,CALL,投信,39,150,0,0,39,150,221,819,159,413,62,406
2015/11/24,臺指選擇權,CALL,外資及陸資,45501,113681,40872,107955,4629,5726,129888,212127,84478,183929,45410,28198
2015/11/24,臺指選擇權,PUT,自營商,195822,387354,202651,407999,-6829,-20645,100753,297756,117697,509580,-16944,-211824
2015/11/24,臺指選擇權,PUT,投信,0,0,0,0,0,0,64,595,135,608,-71,-13
2015/11/24,臺指選擇權,PUT,外資及陸資,50186,131554,48754,144467,1432,-12914,87727,843309,58046,569684,29681,273625
2015/11/25,臺指選擇權,CALL,自營商,208084,341985,223108,342909,-15024,-925,54851,224794,85019,152851,-30168,71943
2015/11/25,臺指選擇權,CALL,投信,27,139,53,112,-26,27,91,539,117,370,-26,169
2015/11/25,臺指選擇權,CALL,外資及陸資,31753,78954,31206,74231,547,4723,128749,205693,83256,171618,45493,34075
2015/11/25,臺指選擇權,PUT,自營商,214339,441882,217247,418153,-2908,23729,61472,274673,92689,474125,-31217,-199452
2015/11/25,臺指選擇權,PUT,投信,0,0,53,240,-53,-240,64,627,117,687,-53,-60
2015/11/25,臺指選擇權,PUT,外資及陸資,41277,107303,35325,101444,5952,5858,89773,857282,57130,576631,32643,280651
2015/11/26,臺指選擇權,CALL,自營商,125504,325173,120409,335464,5095,-10291,67677,301311,92827,236009,-25150,65302
2015/11/26,臺指選擇權,CALL,投信,36,280,52,182,-16,98,127,1084,169,767,-42,317
2015/11/26,臺指選擇權,CALL,外資及陸資,32055,104348,25709,95163,6346,9186,134999,278232,83159,223393,51840,54839
2015/11/26,臺指選擇權,PUT,自營商,145901,292178,142851,288999,3050,3179,77612,224439,105790,389076,-28178,-164637
2015/11/26,臺指選擇權,PUT,投信,24,154,52,234,-28,-80,88,537,169,583,-81,-46
2015/11/26,臺指選擇權,PUT,外資及陸資,39770,86472,29220,84744,10550,1728,101473,713090,58289,474360,43184,238730
2015/11/27,臺指選擇權,CALL,自營商,134805,253134,144482,299676,-9677,-46541,75486,240011,110544,198550,-35058,41461
2015/11/27,臺指選擇權,CALL,投信,24,104,8,9,16,96,151,811,177,459,-26,352
2015/11/27,臺指選擇權,CALL,外資及陸資,26393,74327,28740,83120,-2347,-8792,135808,222795,86318,183114,49490,39681
2015/11/27,臺指選擇權,PUT,自營商,139325,278954,132281,290990,7044,-12035,95255,349009,116435,535542,-21180,-186533
2015/11/27,臺指選擇權,PUT,投信,0,0,8,40,-8,-40,88,836,177,1081,-89,-245
2015/11/27,臺指選擇權,PUT,外資及陸資,33115,86110,26166,89582,6949,-3471,109203,869268,59010,585704,50193,283564
2015/11/30,臺指選擇權,CALL,自營商,194800,416385,221668,428403,-26868,-12018,84177,236729,146094,202121,-61917,34608
2015/11/30,臺指選擇權,CALL,投信,48,231,0,0,48,231,199,698,177,273,22,425
2015/11/30,臺指選擇權,CALL,外資及陸資,59548,161287,50074,140082,9474,21204,145167,225650,86239,161139,58928,64511
2015/11/30,臺指選擇權,PUT,自營商,224597,669335,225539,639991,-942,29344,103930,493158,125929,664494,-21999,-171336
2015/11/30,臺指選擇權,PUT,投信,12,39,0,0,12,39,100,1191,177,1571,-77,-380
2015/11/30,臺指選擇權,PUT,外資及陸資,68309,231600,70166,251545,-1857,-19945,110447,1023390,62103,702095,48344,321295
2015/12/1,臺指選擇權,CALL,自營商,192029,443941,178338,397851,13691,46090,99654,431296,147987,346666,-48333,84630
2015/12/1,臺指選擇權,CALL,投信,39,133,0,0,39,133,238,1577,177,509,61,1068
2015/12/1,臺指選擇權,CALL,外資及陸資,42926,136066,37572,126552,5354,9514,149369,325458,85095,216141,64274,109317
2015/12/1,臺指選擇權,PUT,自營商,187400,314713,194154,298316,-6754,16398,106805,287339,135592,428034,-28787,-140695
2015/12/1,臺指選擇權,PUT,投信,0,0,0,0,0,0,100,641,177,634,-77,7
2015/12/1,臺指選擇權,PUT,外資及陸資,42567,104128,32871,87943,9696,16185,114673,771415,56625,512779,58048,258636
2015/12/2,臺指選擇權,CALL,自營商,217768,394036,221473,437203,-3705,-43167,62666,284941,113591,273580,-50925,11361
2015/12/2,臺指選擇權,CALL,投信,27,152,93,279,-66,-127,115,833,181,696,-66,137
2015/12/2,臺指選擇權,CALL,外資及陸資,45227,119195,47954,138857,-2727,-19662,146434,306499,86119,215278,60315,91221
2015/12/2,臺指選擇權,PUT,自營商,198713,282765,198705,287276,8,-4511,73660,274402,102486,425391,-28826,-150989
2015/12/2,臺指選擇權,PUT,投信,0,0,73,356,-73,-356,88,638,161,777,-73,-139
2015/12/2,臺指選擇權,PUT,外資及陸資,36909,83681,39978,95910,-3069,-12229,105780,766988,59654,520455,46126,246533
2015/12/3,臺指選擇權,CALL,自營商,139341,336123,137427,360126,1914,-24002,79953,315489,128995,343052,-49042,-27563
2015/12/3,臺指選擇權,CALL,投信,17,103,18,39,-1,64,132,992,199,802,-67,190
2015/12/3,臺指選擇權,CALL,外資及陸資,30603,100058,30752,107928,-149,-7870,148260,319670,88043,232233,60217,87437
2015/12/3,臺指選擇權,PUT,自營商,139952,333563,135703,326352,4249,7211,92017,289719,116583,433852,-24566,-144133
2015/12/3,臺指選擇權,PUT,投信,0,0,18,73,-18,-73,88,590,179,756,-91,-166
2015/12/3,臺指選擇權,PUT,外資及陸資,30506,89332,27908,95289,2598,-5957,110845,747845,62126,513304,48719,234541
2015/12/4,臺指選擇權,CALL,自營商,128431,286238,139614,304892,-11183,-18654,81124,256887,141515,268484,-60391,-11597
2015/12/4,臺指選擇權,CALL,投信,31,161,30,58,1,103,163,806,229,505,-66,301
2015/12/4,臺指選擇權,CALL,外資及陸資,28316,80553,33821,101574,-5505,-21021,148077,245925,93367,200909,54710,45016
2015/12/4,臺指選擇權,PUT,自營商,151343,381810,141519,329350,9824,52461,105677,377140,120347,486509,-14670,-109369
2015/12/4,臺指選擇權,PUT,投信,0,0,11,36,-11,-36,88,761,190,1060,-102,-299
2015/12/4,臺指選擇權,PUT,外資及陸資,37533,117005,32636,118090,4897,-1085,118742,840194,65123,586595,53619,253599
2015/12/7,臺指選擇權,CALL,自營商,162539,382587,143794,318122,18745,64465,84371,293637,126292,263159,-41921,30478
2015/12/7,臺指選擇權,CALL,投信,48,217,12,19,36,197,211,1202,241,578,-30,624
2015/12/7,臺指選擇權,CALL,外資及陸資,38928,119046,35682,115609,3246,3437,152721,281400,94712,231394,58009,50006
2015/12/7,臺指選擇權,PUT,自營商,151473,260932,158671,286485,-7198,-25552,106041,251776,128003,408814,-21962,-157038
2015/12/7,臺指選擇權,PUT,投信,0,0,0,0,0,0,88,484,190,534,-102,-50
2015/12/7,臺指選擇權,PUT,外資及陸資,35227,88442,32356,86455,2871,1986,122767,717302,66268,490649,56499,226653
2015/12/8,臺指選擇權,CALL,自營商,175288,258277,195782,298189,-20494,-39912,84329,193058,146623,165926,-62294,27132
2015/12/8,臺指選擇權,CALL,投信,28,85,0,0,28,85,239,475,241,170,-2,305
2015/12/8,臺指選擇權,CALL,外資及陸資,24470,62185,28776,74852,-4306,-12667,151586,190495,97865,164012,53721,26483
2015/12/8,臺指選擇權,PUT,自營商,178029,362160,177358,387015,671,-24855,111571,410096,132870,584503,-21299,-174407
2015/12/8,臺指選擇權,PUT,投信,5,18,0,0,5,18,93,902,190,1249,-97,-347
2015/12/8,臺指選擇權,PUT,外資及陸資,44365,178959,37222,168444,7143,10515,134624,990262,71124,700835,63500,289427
2015/12/9,臺指選擇權,CALL,自營商,251013,382870,273858,392833,-22845,-9963,57488,158037,132195,115990,-74707,42047
2015/12/9,臺指選擇權,CALL,投信,11,58,45,107,-34,-49,99,161,153,152,-54,9
2015/12/9,臺指選擇權,CALL,外資及陸資,32999,78484,32083,75316,916,3168,146734,144961,97611,116611,49123,28350
2015/12/9,臺指選擇權,PUT,自營商,243946,596790,245413,542135,-1467,54655,87949,504213,117103,646423,-29154,-142210
2015/12/9,臺指選擇權,PUT,投信,0,0,43,219,-43,-219,88,1280,131,1126,-43,154
2015/12/9,臺指選擇權,PUT,外資及陸資,45419,140571,43585,152208,1834,-11637,132991,1158332,70945,851439,62046,306893
2015/12/10,臺指選擇權,CALL,自營商,176593,357446,189712,393723,-13119,-36277,66785,164345,154708,152226,-87923,12119
2015/12/10,臺指選擇權,CALL,投信,11,59,15,27,-4,32,110,166,168,128,-58,38
2015/12/10,臺指選擇權,CALL,外資及陸資,37862,112101,31912,100667,5950,11434,153366,144900,98282,107237,55084,37663
2015/12/10,臺指選擇權,PUT,自營商,184103,521998,174296,564592,9807,-42595,103597,549328,123176,713880,-19579,-164552
2015/12/10,臺指選擇權,PUT,投信,0,0,13,62,-13,-62,88,1395,144,1323,-56,72
2015/12/10,臺指選擇權,PUT,外資及陸資,43910,195285,37103,174613,6807,20672,138709,1241201,69862,906451,68847,334750
2015/12/11,臺指選擇權,CALL,自營商,160400,268437,167097,271531,-6697,-3094,67426,109495,162527,73734,-95101,35761
2015/12/11,臺指選擇權,CALL,投信,40,228,15,26,25,202,150,269,183,49,-33,220
2015/12/11,臺指選擇權,CALL,外資及陸資,36648,89469,37304,86014,-656,3454,158846,115044,104488,81507,54358,33537
2015/12/11,臺指選擇權,PUT,自營商,150077,408947,154526,455739,-4449,-46792,103228,734951,127241,934366,-24013,-199415
2015/12/11,臺指選擇權,PUT,投信,0,0,3,12,-3,-12,88,1901,147,1998,-59,-97
2015/12/11,臺指選擇權,PUT,外資及陸資,47221,176990,44237,179962,2984,-2972,145363,1507675,73492,1122566,71871,385109
2015/12/14,臺指選擇權,CALL,自營商,157120,267685,165296,251175,-8176,16509,75139,142120,178846,81133,-103707,60987
2015/12/14,臺指選擇權,CALL,投信,50,367,26,264,24,103,198,542,207,267,-9,275
2015/12/14,臺指選擇權,CALL,外資及陸資,37061,99542,37046,95292,15,4250,162327,120619,107913,83160,54414,37459
2015/12/14,臺指選擇權,PUT,自營商,161778,450557,172965,482984,-11187,-32427,102909,730504,138062,951704,-35153,-221200
2015/12/14,臺指選擇權,PUT,投信,60,412,24,279,36,134,148,2333,171,2284,-23,49
2015/12/14,臺指選擇權,PUT,外資及陸資,49548,176675,52626,193443,-3078,-16768,144628,1527827,75848,1165789,68780,362038
2015/12/15,臺指選擇權,CALL,自營商,127476,200148,128062,219553,-586,-19405,77808,126993,182181,80727,-104373,46266
2015/12/15,臺指選擇權,CALL,投信,12,50,0,0,12,50,210,544,207,249,3,295
2015/12/15,臺指選擇權,CALL,外資及陸資,36509,84034,35182,87719,1327,-3685,164243,111744,108429,79537,55814,32207
2015/12/15,臺指選擇權,PUT,自營商,139703,285848,139502,272108,201,13740,106951,726620,142118,929046,-35167,-202426
2015/12/15,臺指選擇權,PUT,投信,0,0,0,0,0,0,148,2281,171,2246,-23,35
2015/12/15,臺指選擇權,PUT,外資及陸資,35194,103223,35576,104654,-382,-1431,143984,1502161,75618,1148515,68366,353646
2015/12/16,臺指選擇權,CALL,自營商,203048,421360,206943,424431,-3895,-3070,39040,146436,31347,98317,7693,48119
2015/12/16,臺指選擇權,CALL,投信,34,261,54,326,-20,-65,58,645,78,630,-20,15
2015/12/16,臺指選擇權,CALL,外資及陸資,45512,115779,35037,105287,10475,10492,69028,153748,38708,93414,30320,60334
2015/12/16,臺指選擇權,PUT,自營商,194178,399790,215407,400963,-21229,-1173,48670,245644,45929,280392,2741,-34748
2015/12/16,臺指選擇權,PUT,投信,34,184,48,362,-14,-178,58,407,72,544,-14,-137
2015/12/16,臺指選擇權,PUT,外資及陸資,38641,111189,32281,87232,6360,23956,54316,579942,37529,445971,16787,133971
2015/12/17,臺指選擇權,CALL,自營商,106164,304356,103490,308026,2674,-3671,56995,216796,46615,172362,10380,44434
2015/12/17,臺指選擇權,CALL,投信,62,568,79,656,-17,-88,120,1354,157,1456,-37,-102
2015/12/17,臺指選擇權,CALL,外資及陸資,30827,106633,27338,103265,3489,3368,72980,178255,39187,107801,33793,70454
2015/12/17,臺指選擇權,PUT,自營商,122062,284634,113413,294209,8649,-9575,71123,208974,59790,233908,11333,-24934
2015/12/17,臺指選擇權,PUT,投信,40,260,79,496,-39,-236,98,490,151,789,-53,-299
2015/12/17,臺指選擇權,PUT,外資及陸資,31488,89141,29046,97979,2442,-8838,59441,433393,40169,351886,19272,81507
2015/12/18,臺指選擇權,CALL,自營商,121284,295274,118557,297482,2727,-2209,69272,209639,56071,160519,13201,49120
2015/12/18,臺指選擇權,CALL,投信,13,57,25,35,-12,22,133,1190,182,1226,-49,-36
2015/12/18,臺指選擇權,CALL,外資及陸資,28638,103676,28223,115939,415,-12263,79445,176924,45213,131352,34232,45572
2015/12/18,臺指選擇權,PUT,自營商,139139,315966,126191,312420,12948,3546,93617,269412,69198,296448,24419,-27036
2015/12/18,臺指選擇權,PUT,投信,29,106,15,19,14,87,127,660,166,941,-39,-281
2015/12/18,臺指選擇權,PUT,外資及陸資,26629,91700,31635,142535,-5006,-50835,61546,486305,47328,447528,14218,38777
2015/12/21,臺指選擇權,CALL,自營商,143725,300185,145156,307654,-1431,-7469,78974,273827,67246,246356,11728,27471
2015/12/21,臺指選擇權,CALL,投信,48,101,0,0,48,101,181,1497,182,1430,-1,67
2015/12/21,臺指選擇權,CALL,外資及陸資,27833,84206,27434,84420,399,-214,81349,200849,46754,150591,34595,50258
2015/12/21,臺指選擇權,PUT,自營商,139522,294246,141921,288888,-2399,5358,98562,234368,76599,249440,21963,-15072
2015/12/21,臺指選擇權,PUT,投信,36,50,0,0,36,50,163,562,166,688,-3,-126
2015/12/21,臺指選擇權,PUT,外資及陸資,29257,86460,27392,81559,1865,4900,63688,440748,47571,405698,16117,35050
2015/12/22,臺指選擇權,CALL,自營商,125731,231599,119136,248352,6595,-16753,91551,268757,73231,252417,18320,16340
2015/12/22,臺指選擇權,CALL,投信,24,84,12,7,12,77,205,1481,194,1324,11,157
2015/12/22,臺指選擇權,CALL,外資及陸資,25160,69981,25500,75582,-340,-5600,82104,192085,47841,149264,34263,42821
2015/12/22,臺指選擇權,PUT,自營商,130485,228234,122810,230100,7675,-1866,111235,235903,81633,256397,29602,-20494
2015/12/22,臺指選擇權,PUT,投信,18,56,0,0,18,56,181,577,166,642,15,-65
2015/12/22,臺指選擇權,PUT,外資及陸資,22233,52470,22799,62252,-566,-9783,65022,444079,49484,418404,15538,25675
2015/12/23,臺指選擇權,CALL,自營商,195268,344804,178074,297324,17194,47480,63743,218207,48781,145905,14962,72302
2015/12/23,臺指選擇權,CALL,投信,36,156,63,77,-27,79,116,1199,143,1239,-27,-40
2015/12/23,臺指選擇權,CALL,外資及陸資,30190,81550,29603,79427,587,2123,82319,188077,48199,145359,34120,42718
2015/12/23,臺指選擇權,PUT,自營商,185560,277863,203412,274505,-17852,3358,67200,214191,58893,240067,8307,-25876
2015/12/23,臺指選擇權,PUT,投信,18,7,57,210,-39,-203,98,403,137,670,-39,-267
2015/12/23,臺指選擇權,PUT,外資及陸資,28976,60703,29418,68937,-442,-8235,59126,415623,51545,399479,7581,16144
2015/12/24,臺指選擇權,CALL,自營商,106643,225800,108350,237354,-1707,-11554,77429,253641,64311,182753,13118,70888
2015/12/24,臺指選擇權,CALL,投信,30,159,49,75,-19,84,146,1484,192,1408,-46,76
2015/12/24,臺指選擇權,CALL,外資及陸資,25457,77209,23206,70912,2251,6297,87912,213822,51570,162822,36342,51000
2015/12/24,臺指選擇權,PUT,自營商,113124,220627,121452,269548,-8328,-48922,73442,218856,73555,292173,-113,-73317
2015/12/24,臺指選擇權,PUT,投信,3,1,49,162,-46,-161,101,362,186,750,-85,-388
2015/12/24,臺指選擇權,PUT,外資及陸資,26372,87342,24340,83011,2032,4332,62796,413287,53196,394724,9600,18563
2015/12/25,臺指選擇權,CALL,自營商,63699,127593,60700,125807,2999,1785,83506,306854,67389,223946,16117,82908
2015/12/25,臺指選擇權,CALL,投信,48,235,35,43,13,192,194,1982,227,1701,-33,281
2015/12/25,臺指選擇權,CALL,外資及陸資,11586,35376,10748,34309,838,1067,89338,250838,52158,188857,37180,61981
2015/12/25,臺指選擇權,PUT,自營商,85659,141822,84605,161960,1054,-20139,80717,187318,79776,252922,941,-65604
2015/12/25,臺指選擇權,PUT,投信,6,1,23,67,-17,-66,107,286,209,536,-102,-250
2015/12/25,臺指選擇權,PUT,外資及陸資,14395,41681,12868,37555,1527,4126,64322,364220,53195,345943,11127,18277
2015/12/28,臺指選擇權,CALL,自營商,76624,135469,77521,149201,-897,-13732,86226,282620,71006,211752,15220,70868
2015/12/28,臺指選擇權,CALL,投信,0,0,0,0,0,0,194,1774,227,1525,-33,249
2015/12/28,臺指選擇權,CALL,外資及陸資,15302,40197,15143,43290,159,-3093,90280,238691,52941,181000,37339,57691
2015/12/28,臺指選擇權,PUT,自營商,76462,120365,76294,120752,168,-387,86137,201038,85028,273927,1109,-72889
2015/12/28,臺指選擇權,PUT,投信,0,0,0,0,0,0,107,302,209,580,-102,-278
2015/12/28,臺指選擇權,PUT,外資及陸資,16847,36192,14626,39155,2221,-2963,66581,378835,53233,361369,13348,17466
2015/12/29,臺指選擇權,CALL,自營商,124348,198763,132085,220988,-7737,-22225,89394,239960,81921,189563,7473,50397
2015/12/29,臺指選擇權,CALL,投信,12,36,12,6,0,30,206,1303,239,1161,-33,142
2015/12/29,臺指選擇權,CALL,外資及陸資,23727,57138,22268,59121,1459,-1982,90973,196441,52187,151014,38786,45427
2015/12/29,臺指選擇權,PUT,自營商,121224,221241,117414,197876,3810,23366,92275,253780,87374,326021,4901,-72241
2015/12/29,臺指選擇權,PUT,投信,6,0,0,0,6,0,113,365,209,830,-96,-465
2015/12/29,臺指選擇權,PUT,外資及陸資,23652,61885,20910,66624,2742,-4738,70089,435270,53964,417353,16125,17917
2015/12/30,臺指選擇權,CALL,自營商,153194,200773,155882,230510,-2688,-29737,67581,211425,59029,163242,8552,48183
2015/12/30,臺指選擇權,CALL,投信,12,62,54,102,-42,-40,92,1008,134,1149,-42,-141
2015/12/30,臺指選擇權,CALL,外資及陸資,27580,56948,26672,58545,908,-1597,91252,183091,52313,140939,38939,42152
2015/12/30,臺指選擇權,PUT,自營商,157336,245984,163667,254870,-6331,-8886,75069,241409,69017,296285,6052,-54876
2015/12/30,臺指選擇權,PUT,投信,18,4,54,154,-36,-150,98,404,134,623,-36,-219
2015/12/30,臺指選擇權,PUT,外資及陸資,29095,63952,27608,77123,1487,-13171,68331,460216,55759,453692,12572,6524
2015/12/31,臺指選擇權,CALL,自營商,92775,191575,82365,180302,10410,11273,84020,245741,65011,187154,19009,58587
2015/12/31,臺指選擇權,CALL,投信,30,129,29,34,1,95,122,1181,163,1254,-41,-73
2015/12/31,臺指選擇權,CALL,外資及陸資,17338,56522,16753,48090,585,8432,95368,205540,55847,154114,39521,51426
2015/12/31,臺指選擇權,PUT,自營商,102623,204878,114277,284581,-11654,-79702,88435,245709,94045,375556,-5610,-129847
2015/12/31,臺指選擇權,PUT,投信,3,1,29,111,-26,-109,101,406,163,725,-62,-319
2015/12/31,臺指選擇權,PUT,外資及陸資,24724,70543,20224,71365,4500,-822,75680,464993,58629,459706,17051,5287
2016/1/4,臺指選擇權,CALL,自營商,253062,456667,268188,459752,-15126,-3085,88109,176736,84226,97288,3883,79448
2016/1/4,臺指選擇權,CALL,投信,60,234,0,0,60,234,182,786,163,594,19,192
2016/1/4,臺指選擇權,CALL,外資及陸資,43341,111122,44147,113001,-806,-1879,97431,112980,58716,86901,38715,26079
2016/1/4,臺指選擇權,PUT,自營商,256620,832795,256742,761935,-122,70860,93032,474153,98764,614717,-5732,-140564
2016/1/4,臺指選擇權,PUT,投信,0,0,0,0,0,0,101,735,163,1617,-62,-882
2016/1/4,臺指選擇權,PUT,外資及陸資,50469,215044,45534,194770,4935,20274,80362,731124,58376,684602,21986,46522
2016/1/5,臺指選擇權,CALL,自營商,181350,305977,184219,301107,-2869,4870,104664,197639,103671,123262,993,74377
2016/1/5,臺指選擇權,CALL,投信,36,140,0,0,36,140,218,693,163,498,55,195
2016/1/5,臺指選擇權,CALL,外資及陸資,30919,69126,34768,74544,-3849,-5418,97496,101209,62684,80241,34812,20968
2016/1/5,臺指選擇權,PUT,自營商,188088,432090,190708,504111,-2620,-72021,102967,527950,111358,751909,-8391,-223959
2016/1/5,臺指選擇權,PUT,投信,0,0,0,0,0,0,101,839,163,1892,-62,-1053
2016/1/5,臺指選擇權,PUT,外資及陸資,41734,119912,40685,120104,1049,-193,82117,792425,59041,736523,23076,55902
2016/1/6,臺指選擇權,CALL,自營商,288451,451636,305969,434739,-17518,16896,87620,166456,82327,105001,5293,61455
2016/1/6,臺指選擇權,CALL,投信,24,117,25,47,-1,70,104,403,105,379,-1,24
2016/1/6,臺指選擇權,CALL,外資及陸資,49990,116759,50095,107406,-105,9354,100742,93422,62736,62743,38006,30679
2016/1/6,臺指選擇權,PUT,自營商,315036,898508,320027,718280,-4991,180228,87157,472516,88831,612604,-1674,-140088
2016/1/6,臺指選擇權,PUT,投信,73,266,19,95,54,172,153,1065,99,1047,54,18
2016/1/6,臺指選擇權,PUT,外資及陸資,68947,218825,68907,220979,40,-2153,75684,819638,59896,780922,15788,38716
2016/1/7,臺指選擇權,CALL,自營商,244616,480594,260484,467706,-15868,12888,102465,161788,113080,102574,-10615,59214
2016/1/7,臺指選擇權,CALL,投信,24,114,15,24,9,90,128,251,120,150,8,101
2016/1/7,臺指選擇權,CALL,外資及陸資,65272,177998,64315,184960,957,-6962,105623,73977,66681,53895,38942,20082
2016/1/7,臺指選擇權,PUT,自營商,262632,962837,275490,898862,-12858,63975,89629,754422,104222,870101,-14593,-115679
2016/1/7,臺指選擇權,PUT,投信,9,32,15,90,-6,-58,162,1685,114,1742,48,-57
2016/1/7,臺指選擇權,PUT,外資及陸資,82534,385912,68980,354458,13554,31454,92655,1156295,63258,1050286,29397,106009
2016/1/8,臺指選擇權,CALL,自營商,195258,412429,192625,410292,2633,2136,117228,226620,125876,159081,-8648,67539
2016/1/8,臺指選擇權,CALL,投信,40,180,15,19,25,161,168,514,135,223,33,291
2016/1/8,臺指選擇權,CALL,外資及陸資,42640,151494,43863,157273,-1223,-5778,116455,125016,78734,113356,37721,11660
2016/1/8,臺指選擇權,PUT,自營商,208090,535981,207486,572657,604,-36676,97077,632774,111098,752191,-14021,-119417
2016/1/8,臺指選擇權,PUT,投信,0,0,11,31,-11,-31,162,1395,125,1467,37,-72
2016/1/8,臺指選擇權,PUT,外資及陸資,53135,187548,53980,220886,-845,-33337,104692,1036430,76130,991988,28562,44442
2016/1/11,臺指選擇權,CALL,自營商,232910,425178,239219,417995,-6309,7182,120184,162950,135245,111586,-15061,51364
2016/1/11,臺指選擇權,CALL,投信,0,0,0,0,0,0,168,181,135,81,33,100
2016/1/11,臺指選擇權,CALL,外資及陸資,51682,145112,48170,132073,3512,13039,113954,79031,72757,52331,41197,26700
2016/1/11,臺指選擇權,PUT,自營商,236075,699579,243967,710573,-7892,-10994,97850,881681,119761,1035174,-21911,-153493
2016/1/11,臺指選擇權,PUT,投信,0,0,0,0,0,0,162,1970,125,2083,37,-113
2016/1/11,臺指選擇權,PUT,外資及陸資,66216,234604,64701,227635,1515,6969,96805,1283768,66671,1194152,30134,89616
2016/1/12,臺指選擇權,CALL,自營商,201699,346516,190661,332415,11038,14101,143533,159082,147682,98773,-4149,60309
2016/1/12,臺指選擇權,CALL,投信,0,0,0,0,0,0,168,69,135,48,33,21
2016/1/12,臺指選擇權,CALL,外資及陸資,34489,87682,31904,87548,2585,134,120742,74881,77007,52364,43735,22517
2016/1/12,臺指選擇權,PUT,自營商,202633,558065,206239,551690,-3606,6375,105457,928606,130878,1103528,-25421,-174922
2016/1/12,臺指選擇權,PUT,投信,20,46,0,0,20,46,182,2125,125,2256,57,-131
2016/1/12,臺指選擇權,PUT,外資及陸資,40183,148134,48747,206309,-8564,-58176,95251,1318743,73663,1291424,21588,27319
2016/1/13,臺指選擇權,CALL,自營商,259280,462554,256190,470262,3090,-7708,124564,241616,113339,199330,11225,42286
2016/1/13,臺指選擇權,CALL,投信,16,127,25,121,-9,6,96,212,105,211,-9,1
2016/1/13,臺指選擇權,CALL,外資及陸資,54766,137804,59041,175057,-4275,-37253,119883,101054,82557,111378,37326,-10324
2016/1/13,臺指選擇權,PUT,自營商,260015,571121,275019,674120,-15004,-102999,86033,658362,111264,897229,-25231,-238867
2016/1/13,臺指選擇權,PUT,投信,13,46,15,93,-2,-47,173,1615,95,1497,78,118
2016/1/13,臺指選擇權,PUT,外資及陸資,58538,155236,67729,214973,-9191,-59737,84932,1091615,83664,1141129,1268,-49514
2016/1/14,臺指選擇權,CALL,自營商,218803,516227,223422,524472,-4619,-8245,155211,258533,148665,232763,6546,25770
2016/1/14,臺指選擇權,CALL,投信,5,35,9,67,-4,-33,101,139,114,149,-13,-10
2016/1/14,臺指選擇權,CALL,外資及陸資,59289,196349,48670,173925,10619,22424,132066,106147,84075,91122,47991,15025
2016/1/14,臺指選擇權,PUT,自營商,194054,716456,195826,729106,-1772,-12650,117824,849397,144830,1158425,-27006,-309028
2016/1/14,臺指選擇權,PUT,投信,28,178,12,50,16,129,201,2170,107,1881,94,289
2016/1/14,臺指選擇權,PUT,外資及陸資,60003,291514,57051,275509,2952,16005,91481,1262627,87260,1315230,4221,-52603
2016/1/15,臺指選擇權,CALL,自營商,211798,451127,236698,467000,-24900,-15873,155436,185894,173803,159141,-18367,26753
2016/1/15,臺指選擇權,CALL,投信,72,209,6,13,66,196,173,273,120,88,53,185
2016/1/15,臺指選擇權,CALL,外資及陸資,68089,205770,58544,194251,9545,11519,143494,97316,85895,74722,57599,22594
2016/1/15,臺指選擇權,PUT,自營商,208095,640681,220301,652981,-12206,-12300,109566,904090,148785,1222229,-39219,-318139
2016/1/15,臺指選擇權,PUT,投信,66,217,8,28,58,189,267,2558,115,2091,152,467
2016/1/15,臺指選擇權,PUT,外資及陸資,84860,336516,86856,369706,-1996,-33189,96656,1345659,94433,1433398,2223,-87739
2016/1/18,臺指選擇權,CALL,自營商,284141,601018,298111,575836,-13970,25182,153491,292993,186089,269961,-32598,23032
2016/1/18,臺指選擇權,CALL,投信,10,18,0,0,10,18,183,432,120,123,63,309
2016/1/18,臺指選擇權,CALL,外資及陸資,72009,222924,62913,213714,9096,9210,152272,168188,85672,101508,66600,66680
2016/1/18,臺指選擇權,PUT,自營商,315027,671807,312260,604983,2767,66825,108386,602602,144857,750985,-36471,-148383
2016/1/18,臺指選擇權,PUT,投信,32,108,0,0,32,108,299,1570,115,1364,184,206
2016/1/18,臺指選擇權,PUT,外資及陸資,96755,218034,76628,198308,20127,19726,105118,984927,82763,1026179,22355,-41252
2016/1/19,臺指選擇權,CALL,自營商,158185,275475,172988,275276,-14803,198,141655,305008,189146,309863,-47491,-4855
2016/1/19,臺指選擇權,CALL,投信,96,991,106,720,-10,270,279,1754,226,1064,53,690
2016/1/19,臺指選擇權,CALL,外資及陸資,50708,123070,50852,133166,-144,-10096,152013,186946,85556,119704,66457,67242
2016/1/19,臺指選擇權,PUT,自營商,182408,293380,172980,269928,9428,23451,121198,523433,148184,635068,-26986,-111635
2016/1/19,臺指選擇權,PUT,投信,101,927,96,718,5,209,400,1907,211,1666,189,241
2016/1/19,臺指選擇權,PUT,外資及陸資,61139,157687,48509,115090,12630,42596,116955,905869,81917,906469,35038,-600
2016/1/20,臺指選擇權,CALL,自營商,283306,388910,295646,428018,-12340,-39108,62864,132205,55803,89728,7061,42477
2016/1/20,臺指選擇權,CALL,投信,41,299,40,309,1,-10,187,1024,136,754,51,270
2016/1/20,臺指選擇權,CALL,外資及陸資,37269,75609,33075,78890,4194,-3281,70654,71553,53037,60089,17617,11464
2016/1/20,臺指選擇權,PUT,自營商,256576,582555,272401,701311,-15825,-118756,45458,441906,59372,599117,-13914,-157211
2016/1/20,臺指選擇權,PUT,投信,35,252,35,353,0,-101,231,2350,131,1567,100,783
2016/1/20,臺指選擇權,PUT,外資及陸資,46155,156987,42393,163308,3762,-6321,53090,916026,56744,979024,-3654,-62998
2016/1/21,臺指選擇權,CALL,自營商,155970,406969,133193,385913,22777,21055,97917,202238,68206,144940,29711,57298
2016/1/21,臺指選擇權,CALL,投信,32,187,14,30,18,157,219,1181,150,772,69,409
2016/1/21,臺指選擇權,CALL,外資及陸資,45294,152790,37006,134841,8288,17949,79175,83350,53308,59079,25867,24271
2016/1/21,臺指選擇權,PUT,自營商,166990,527853,159544,555640,7446,-27786,78054,481707,84457,647840,-6403,-166133
2016/1/21,臺指選擇權,PUT,投信,8,31,14,90,-6,-58,236,2124,142,1506,94,618
2016/1/21,臺指選擇權,PUT,外資及陸資,62361,237211,48877,218798,13484,18414,69492,914570,59580,950779,9912,-36209
2016/1/22,臺指選擇權,CALL,自營商,139589,348196,137976,348051,1613,145,108328,317592,77110,240165,31218,77427
2016/1/22,臺指選擇權,CALL,投信,42,173,14,11,28,163,239,1743,142,1014,97,729
2016/1/22,臺指選擇權,CALL,外資及陸資,43831,126395,38155,119964,5676,6431,86133,117773,54576,78919,31557,38854
2016/1/22,臺指選擇權,PUT,自營商,171312,403176,151652,394766,19660,8409,106089,363939,92790,442721,13299,-78782
2016/1/22,臺指選擇權,PUT,投信,0,0,14,74,-14,-74,236,1293,156,984,80,309
2016/1/22,臺指選擇權,PUT,外資及陸資,51729,146218,43392,141710,8337,4508,79939,716389,61696,742727,18243,-26338
2016/1/25,臺指選擇權,CALL,自營商,132043,347675,139361,337576,-7318,10099,105998,393408,81907,285875,24091,107533
2016/1/25,臺指選擇權,CALL,投信,32,134,10,12,22,122,271,2293,152,1208,119,1085
2016/1/25,臺指選擇權,CALL,外資及陸資,56204,176794,48998,155169,7206,21626,98954,160005,60158,95749,38796,64256
2016/1/25,臺指選擇權,PUT,自營商,150848,309535,172588,294945,-21740,14590,108680,313405,117234,335114,-8554,-21709
2016/1/25,臺指選擇權,PUT,投信,5,1,0,0,5,1,241,809,156,582,85,227
2016/1/25,臺指選擇權,PUT,外資及陸資,48771,125043,47599,123858,1172,1185,84189,598671,64818,614640,19371,-15969
2016/1/26,臺指選擇權,CALL,自營商,113214,214271,124020,230797,-10806,-16526,104513,315142,91259,248720,13254,66422
2016/1/26,臺指選擇權,CALL,投信,37,150,0,0,37,150,308,1978,152,940,156,1038
2016/1/26,臺指選擇權,CALL,外資及陸資,34038,89192,32314,79915,1724,9277,101739,132002,61170,77880,40569,54122
2016/1/26,臺指選擇權,PUT,自營商,143631,239579,126451,243531,17180,-3952,118627,348751,109991,379639,8636,-30888
2016/1/26,臺指選擇權,PUT,投信,0,0,0,0,0,0,241,910,156,666,85,244
2016/1/26,臺指選擇權,PUT,外資及陸資,40662,106777,36144,95479,4518,11298,89098,667408,65181,675676,23917,-8268
2016/1/27,臺指選擇權,CALL,自營商,160825,297505,145526,245736,15299,51769,81602,267665,62863,155780,18739,111885
2016/1/27,臺指選擇權,CALL,投信,27,155,43,93,-16,62,197,1479,163,1119,34,360
2016/1/27,臺指選擇權,CALL,外資及陸資,35662,93073,31363,86817,4299,6256,90154,147986,57089,88103,33065,59883
2016/1/27,臺指選擇權,PUT,自營商,152131,235541,162202,274299,-10071,-38758,68484,287582,82202,339817,-13718,-52235
2016/1/27,臺指選擇權,PUT,投信,11,13,43,202,-32,-189,231,668,163,629,68,39
2016/1/27,臺指選擇權,PUT,外資及陸資,39827,87640,31077,76801,8750,10839,80740,596668,65317,596043,15423,625
2016/1/28,臺指選擇權,CALL,自營商,111795,276651,116691,307499,-4896,-30848,85254,270123,71592,189644,13662,80479
2016/1/28,臺指選擇權,CALL,投信,12,52,29,35,-17,17,209,1570,192,1205,17,365
2016/1/28,臺指選擇權,CALL,外資及陸資,33437,109836,31533,117663,1904,-7826,92821,151930,57832,96355,34989,55575
2016/1/28,臺指選擇權,PUT,自營商,147549,252283,128165,228906,19384,23377,95671,306110,90016,320806,5655,-14696
2016/1/28,臺指選擇權,PUT,投信,3,2,29,134,-26,-132,234,560,192,639,42,-79
2016/1/28,臺指選擇權,PUT,外資及陸資,42865,90865,32278,99993,10587,-9128,92581,561764,66568,573218,26013,-11454
2016/1/29,臺指選擇權,CALL,自營商,198682,536134,207543,578130,-8861,-41996,86305,498696,81606,392689,4699,106007
2016/1/29,臺指選擇權,CALL,投信,32,166,24,50,8,116,241,3162,216,2531,25,631
2016/1/29,臺指選擇權,CALL,外資及陸資,69118,257132,60780,248890,8338,8242,103585,344504,60214,185558,43371,158946
2016/1/29,臺指選擇權,PUT,自營商,217257,385344,239220,383216,-21963,2128,102559,231756,118922,217022,-16363,14734
2016/1/29,臺指選擇權,PUT,投信,0,0,14,46,-14,-46,234,234,206,241,28,-7
2016/1/29,臺指選擇權,PUT,外資及陸資,70615,151666,58675,151343,11940,323,108184,397861,70255,402990,37929,-5129
2016/1/30,臺指選擇權,CALL,自營商,102459,329823,104926,314807,-2467,15015,90636,697969,88384,524928,2252,173041
2016/1/30,臺指選擇權,CALL,投信,0,0,0,0,0,0,241,4170,216,3416,25,754
2016/1/30,臺指選擇權,CALL,外資及陸資,17307,65894,14535,66592,2772,-699,105507,505568,59410,245476,46097,260092
2016/1/30,臺指選擇權,PUT,自營商,117888,207133,140624,213346,-22736,-6213,110363,216372,149546,200358,-39183,16014
2016/1/30,臺指選擇權,PUT,投信,0,0,0,0,0,0,234,116,206,103,28,13
2016/1/30,臺指選擇權,PUT,外資及陸資,12391,18419,11722,19170,669,-751,108144,309075,69524,316055,38620,-6980
2016/2/1,臺指選擇權,CALL,自營商,143037,310806,152808,329095,-9771,-18289,98943,635863,106462,504108,-7519,131755
2016/2/1,臺指選擇權,CALL,投信,0,0,50,295,-50,-295,191,3562,216,3145,-25,417
2016/2/1,臺指選擇權,CALL,外資及陸資,43020,121836,45198,159365,-2178,-37529,105019,410501,61100,224474,43919,186027
2016/2/1,臺指選擇權,PUT,自營商,155631,280782,149934,242513,5697,38269,122573,269961,156059,217863,-33486,52098
2016/2/1,臺指選擇權,PUT,投信,0,0,0,0,0,0,234,148,206,124,28,24
2016/2/1,臺指選擇權,PUT,外資及陸資,43939,101155,37462,99277,6477,1878,112064,342576,66967,348951,45097,-6375
2016/2/2,臺指選擇權,CALL,自營商,126100,222562,116239,226566,9861,-4004,108111,580764,105787,454362,2324,126402
2016/2/2,臺指選擇權,CALL,投信,0,0,0,0,0,0,191,3320,216,2866,-25,454
2016/2/2,臺指選擇權,CALL,外資及陸資,32754,85864,36063,102179,-3309,-16315,105927,367193,65341,220083,40586,147110
2016/2/2,臺指選擇權,PUT,自營商,127255,187357,131562,191027,-4307,-3670,127078,291056,164807,239516,-37729,51540
2016/2/2,臺指選擇權,PUT,投信,2200,1672,0,0,2200,1672,2434,1792,206,109,2228,1683
2016/2/2,臺指選擇權,PUT,外資及陸資,33307,65760,31703,74205,1604,-8445,115262,362396,68483,376881,46779,-14485
2016/2/3,臺指選擇權,CALL,自營商,193937,314853,215281,373261,-21344,-58409,75821,358137,81931,269999,-6110,88138
2016/2/3,臺指選擇權,CALL,投信,17,86,32,57,-15,29,137,2220,152,1892,-15,328
2016/2/3,臺指選擇權,CALL,外資及陸資,57519,132477,44396,129036,13123,3441,108676,260046,64910,177429,43766,82617
2016/2/3,臺指選擇權,PUT,自營商,210036,368704,226944,382225,-16908,-13521,85884,347512,107616,310375,-21732,37137
2016/2/3,臺指選擇權,PUT,投信,1461,2049,27,136,1434,1914,3881,4392,147,266,3734,4126
2016/2/3,臺指選擇權,PUT,外資及陸資,70914,176108,49858,143497,21056,32612,118026,462971,67499,449724,50527,13247
2016/2/15,臺指選擇權,CALL,自營商,177218,312897,185998,326050,-8780,-13153,69565,318796,81018,253517,-11453,65279
2016/2/15,臺指選擇權,CALL,投信,0,0,0,0,0,0,120,2076,120,1730,0,346
2016/2/15,臺指選擇權,CALL,外資及陸資,40919,130084,33020,109166,7899,20918,110154,225329,65308,153828,44846,71501
2016/2/15,臺指選擇權,PUT,自營商,206358,280940,209719,306166,-3361,-25226,79213,265711,97790,233402,-18577,32309
2016/2/15,臺指選擇權,PUT,投信,0,0,0,0,0,0,3870,483,120,7,3750,476
2016/2/15,臺指選擇權,PUT,外資及陸資,44984,102732,41077,117132,3907,-14400,117859,401434,65640,415347,52219,-13913
2016/2/16,臺指選擇權,CALL,自營商,153204,328724,147671,310001,5533,18723,81582,509689,87461,415375,-5879,94314
2016/2/16,臺指選擇權,CALL,投信,49,328,49,465,0,-137,168,3428,168,3222,0,206
2016/2/16,臺指選擇權,CALL,外資及陸資,59368,176461,51761,170116,7607,6345,118585,402183,66116,243218,52469,158965
2016/2/16,臺指選擇權,PUT,自營商,173774,215073,199902,219533,-26128,-4460,90129,199745,134823,167402,-44694,32343
2016/2/16,臺指選擇權,PUT,投信,48,343,48,444,0,-101,3918,504,168,380,3750,124
2016/2/16,臺指選擇權,PUT,外資及陸資,49950,88183,43477,83489,6473,4694,124638,259479,65924,279001,58714,-19522
2016/2/17,臺指選擇權,CALL,自營商,145226,281342,150280,283244,-5054,-1901,54527,208471,45600,150126,8927,58345
2016/2/17,臺指選擇權,CALL,投信,24,192,24,262,0,-70,72,551,72,781,0,-230
2016/2/17,臺指選擇權,CALL,外資及陸資,37958,103165,29347,87147,8611,16018,83311,234457,42826,109348,40485,125109
2016/2/17,臺指選擇權,PUT,自營商,171346,256312,176355,266034,-5009,-9722,34641,179854,56083,177008,-21442,2846
2016/2/17,臺指選擇權,PUT,投信,24,147,24,192,0,-45,122,594,72,590,50,4
2016/2/17,臺指選擇權,PUT,外資及陸資,38547,83362,33268,103261,5279,-19899,36906,230217,35296,259259,1610,-29042
2016/2/18,臺指選擇權,CALL,自營商,104764,279051,100859,291029,3905,-11978,67200,286715,54376,226288,12824,60427
2016/2/18,臺指選擇權,CALL,投信,0,0,0,0,0,0,72,749,72,990,0,-241
2016/2/18,臺指選擇權,CALL,外資及陸資,35000,122264,33130,123543,1870,-1279,88603,319437,46206,148138,42397,171299
2016/2/18,臺指選擇權,PUT,自營商,128762,243791,126855,268164,1907,-24373,65565,192520,85074,191325,-19509,1195
2016/2/18,臺指選擇權,PUT,投信,0,0,0,0,0,0,122,418,72,436,50,-18
2016/2/18,臺指選擇權,PUT,外資及陸資,40176,102605,32830,96754,7346,5850,44623,201166,35634,221479,8989,-20313
2016/2/19,臺指選擇權,CALL,自營商,80045,196377,75306,175395,4739,20982,76355,319534,58742,237696,17613,81838
2016/2/19,臺指選擇權,CALL,投信,60,14,200,43,-140,-30,132,759,272,1066,-140,-307
2016/2/19,臺指選擇權,CALL,外資及陸資,20761,76935,23465,96779,-2704,-19844,94237,342281,54483,193732,39754,148549
2016/2/19,臺指選擇權,PUT,自營商,99573,179823,92771,183797,6802,-3974,89165,200851,101887,188481,-12722,12370
2016/2/19,臺指選擇權,PUT,投信,0,0,0,0,0,0,122,322,72,364,50,-42
2016/2/19,臺指選擇權,PUT,外資及陸資,28166,73210,24551,96116,3615,-22906,55825,200292,43256,240691,12569,-40399
2016/2/22,臺指選擇權,CALL,自營商,126003,283300,134719,310584,-8716,-27284,81592,298921,72669,253859,8923,45062
2016/2/22,臺指選擇權,CALL,投信,0,0,60,6,-60,-6,72,684,272,1002,-200,-318
2016/2/22,臺指選擇權,CALL,外資及陸資,38067,118973,36174,122893,1893,-3920,97515,323244,55909,191150,41606,132094
2016/2/22,臺指選擇權,PUT,自營商,147322,280228,134687,244477,12635,35751,100067,229568,100168,167303,-101,62265
2016/2/22,臺指選擇權,PUT,投信,0,0,0,0,0,0,122,276,72,331,50,-55
2016/2/22,臺指選擇權,PUT,外資及陸資,42361,102155,38885,110070,3476,-7916,60422,199518,44397,243805,16025,-44287
2016/2/23,臺指選擇權,CALL,自營商,102965,172438,93474,168798,9491,3640,91058,312533,72660,262161,18398,50372
2016/2/23,臺指選擇權,CALL,投信,110,73,784,179,-674,-106,172,779,1046,1194,-874,-415
2016/2/23,臺指選擇權,CALL,外資及陸資,21945,61634,20924,55045,1021,6589,99900,331785,57257,194252,42643,137533
2016/2/23,臺指選擇權,PUT,自營商,101462,158678,109379,165131,-7917,-6453,102064,215796,110118,161828,-8054,53968
2016/2/23,臺指選擇權,PUT,投信,0,0,0,0,0,0,122,228,72,284,50,-56
2016/2/23,臺指選擇權,PUT,外資及陸資,27025,70348,21503,55774,5522,14574,66235,201177,44673,227177,21562,-26000
2016/2/24,臺指選擇權,CALL,自營商,181393,309310,178847,283070,2546,26240,68178,250156,56913,171718,11265,78438
2016/2/24,臺指選擇權,CALL,投信,0,0,0,0,0,0,172,612,1046,970,-874,-358
2016/2/24,臺指選擇權,CALL,外資及陸資,44131,94701,35702,96438,8429,-1736,100583,268566,57416,157152,43167,111414
2016/2/24,臺指選擇權,PUT,自營商,196285,310745,202955,348334,-6670,-37588,53555,236855,86103,230006,-32548,6849
2016/2/24,臺指選擇權,PUT,投信,0,0,0,0,0,0,122,342,72,389,50,-47
2016/2/24,臺指選擇權,PUT,外資及陸資,62922,174755,44945,111973,17977,62782,77090,316202,45475,278262,31615,37940
2016/2/25,臺指選擇權,CALL,自營商,119431,298074,97156,237335,22275,60739,91083,385492,57637,231359,33446,154133
2016/2/25,臺指選擇權,CALL,投信,0,0,0,0,0,0,172,832,1046,1264,-874,-432
2016/2/25,臺指選擇權,CALL,外資及陸資,35000,118348,32198,117997,2802,351,104737,356545,58745,212767,45992,143778
2016/2/25,臺指選擇權,PUT,自營商,124466,216986,134401,270871,-9935,-53885,72125,205338,114793,241650,-42668,-36312
2016/2/25,臺指選擇權,PUT,投信,0,0,0,0,0,0,122,220,72,263,50,-43
2016/2/25,臺指選擇權,PUT,外資及陸資,39112,89650,30753,89970,8359,-320,87324,253986,47333,231971,39991,22015
2016/2/26,臺指選擇權,CALL,自營商,102308,220632,104849,272226,-2541,-51594,98501,426804,67600,308437,30901,118367
2016/2/26,臺指選擇權,CALL,投信,140,719,80,908,60,-189,282,1726,1096,2403,-814,-677
2016/2/26,臺指選擇權,CALL,外資及陸資,34661,112572,31563,120205,3098,-7633,109264,416159,60180,258699,49084,157460
2016/2/26,臺指選擇權,PUT,自營商,138158,253275,124540,231141,13618,22134,84912,195506,113927,192909,-29015,2597
2016/2/26,臺指選擇權,PUT,投信,80,756,80,935,0,-179,202,859,152,1067,50,-208
2016/2/26,臺指選擇權,PUT,外資及陸資,44002,101067,33962,92782,10040,8285,100365,230221,50332,209597,50033,20624
2016/3/1,臺指選擇權,CALL,自營商,142384,325704,132238,320971,10146,4733,111043,501370,69926,367319,41117,134051
2016/3/1,臺指選擇權,CALL,投信,96,1031,96,1320,0,-289,348,3033,1162,4053,-814,-1020
2016/3/1,臺指選擇權,CALL,外資及陸資,46014,150009,39577,135890,6437,14119,116630,486778,61105,297034,55525,189744
2016/3/1,臺指選擇權,PUT,自營商,154800,224803,168349,227021,-13549,-2219,88489,177162,131070,148448,-42581,28714
2016/3/1,臺指選擇權,PUT,投信,96,731,96,905,0,-174,298,1371,248,1692,50,-321
2016/3/1,臺指選擇權,PUT,外資及陸資,41738,105170,39539,91287,2199,13883,106554,206227,54338,179215,52216,27012
2016/3/2,臺指選擇權,CALL,自營商,149643,340673,171804,428865,-22161,-88192,72489,448724,60706,347657,11783,101067
2016/3/2,臺指選擇權,CALL,投信,0,0,0,0,0,0,348,3560,1162,4646,-814,-1086
2016/3/2,臺指選擇權,CALL,外資及陸資,40699,140598,44390,156925,-3691,-16327,110252,577834,62475,353784,47777,224050
2016/3/2,臺指選擇權,PUT,自營商,185508,245782,201146,260450,-15638,-14668,63573,156577,108371,146568,-44798,10009
2016/3/2,臺指選擇權,PUT,投信,0,0,0,0,0,0,298,1039,248,1358,50,-319
2016/3/2,臺指選擇權,PUT,外資及陸資,36782,74845,33583,80846,3199,-6001,96359,165901,52790,151630,43569,14271
2016/3/3,臺指選擇權,CALL,自營商,100641,247628,97745,274584,2896,-26956,84473,506589,69721,425796,14752,80793
2016/3/3,臺指選擇權,CALL,投信,215,662,75,799,140,-137,420,4471,1094,5824,-674,-1353
2016/3/3,臺指選擇權,CALL,外資及陸資,28938,105877,30281,116452,-1343,-10575,111950,648313,65473,407441,46477,240872
2016/3/3,臺指選擇權,PUT,自營商,134851,230666,135927,228946,-1076,1720,80681,162353,126602,142120,-45921,20233
2016/3/3,臺指選擇權,PUT,投信,72,572,72,726,0,-154,370,1493,320,1959,50,-466
2016/3/3,臺指選擇權,PUT,外資及陸資,31530,89463,33064,93394,-1534,-3931,97092,147850,55102,136106,41990,11744
2016/3/4,臺指選擇權,CALL,自營商,85021,200384,90971,217132,-5950,-16749,87535,549647,78829,484001,8706,65646
2016/3/4,臺指選擇權,CALL,投信,362,190,0,0,362,190,420,4818,732,6048,-312,-1230
2016/3/4,臺指選擇權,CALL,外資及陸資,28612,88031,30137,104697,-1525,-16666,113049,695833,68079,451801,44970,244032
2016/3/4,臺指選擇權,PUT,自營商,119913,191454,122378,179632,-2465,11821,85032,154599,133465,118236,-48433,36363
2016/3/4,臺指選擇權,PUT,投信,0,0,0,0,0,0,370,1292,320,1669,50,-377
2016/3/4,臺指選擇權,PUT,外資及陸資,37464,97846,30243,88208,7221,9638,108898,153436,59689,131269,49209,22167
2016/3/7,臺指選擇權,CALL,自營商,117436,264071,121992,282546,-4556,-18475,89967,540783,85818,493946,4149,46837
2016/3/7,臺指選擇權,CALL,投信,0,0,0,0,0,0,420,4816,732,6067,-312,-1251
2016/3/7,臺指選擇權,CALL,外資及陸資,31324,105816,34394,122257,-3070,-16441,111584,683598,69664,456026,41920,227572
2016/3/7,臺指選擇權,PUT,自營商,136148,218928,136021,207267,127,11661,94906,174797,143199,123157,-48293,51640
2016/3/7,臺指選擇權,PUT,投信,0,0,0,0,0,0,370,1297,320,1683,50,-386
2016/3/7,臺指選擇權,PUT,外資及陸資,32644,78198,30546,84106,2098,-5907,113042,156018,61719,138582,51323,17436
2016/3/8,臺指選擇權,CALL,自營商,122839,211782,121781,224834,1058,-13052,93526,550028,88309,520111,5217,29917
2016/3/8,臺指選擇權,CALL,投信,100,87,100,116,0,-29,320,4829,632,5976,-312,-1147
2016/3/8,臺指選擇權,CALL,外資及陸資,30220,85517,28656,79431,1564,6086,113550,702389,70067,464521,43483,237868
2016/3/8,臺指選擇權,PUT,自營商,147615,251626,145693,261707,1922,-10081,101628,188274,148110,149846,-46482,38428
2016/3/8,臺指選擇權,PUT,投信,0,0,0,0,0,0,370,1256,320,1621,50,-365
2016/3/8,臺指選擇權,PUT,外資及陸資,42345,134596,34457,104031,7888,30564,124631,196792,65460,155767,59171,41025
2016/3/9,臺指選擇權,CALL,自營商,129116,229107,137548,248196,-8432,-19089,70275,497778,79004,486202,-8729,11576
2016/3/9,臺指選擇權,CALL,投信,0,0,0,0,0,0,320,4808,632,6071,-312,-1263
2016/3/9,臺指選擇權,CALL,外資及陸資,23561,63192,23131,61824,430,1368,111901,698114,68986,456869,42915,241245
2016/3/9,臺指選擇權,PUT,自營商,143840,242948,141861,217525,1979,25422,77170,184732,123368,131593,-46198,53139
2016/3/9,臺指選擇權,PUT,投信,0,0,0,0,0,0,370,1163,320,1530,50,-367
2016/3/9,臺指選擇權,PUT,外資及陸資,31984,69828,27591,70672,4393,-844,123864,188358,63445,149573,60419,38785
2016/3/10,臺指選擇權,CALL,自營商,104142,285856,95694,239222,8448,46634,79728,538930,80015,495451,-287,43479
2016/3/10,臺指選擇權,CALL,投信,0,0,0,0,0,0,320,4965,632,6267,-312,-1302
2016/3/10,臺指選擇權,CALL,外資及陸資,32897,107817,31988,110429,909,-2612,114619,728588,70759,481169,43860,247419
2016/3/10,臺指選擇權,PUT,自營商,121260,212108,134709,231900,-13449,-19792,85116,167611,144687,138973,-59571,28638
2016/3/10,臺指選擇權,PUT,投信,0,0,0,0,0,0,370,1041,320,1398,50,-357
2016/3/10,臺指選擇權,PUT,外資及陸資,47673,93246,30730,86861,16943,6386,141277,186306,63933,146814,77344,39492
2016/3/11,臺指選擇權,CALL,自營商,110386,261693,117875,258428,-7489,3266,83142,628378,90808,599240,-7666,29138
2016/3/11,臺指選擇權,CALL,投信,0,0,0,0,0,0,320,5590,632,6952,-312,-1362
2016/3/11,臺指選擇權,CALL,外資及陸資,32394,110639,30331,104061,2063,6578,116615,858416,70754,562513,45861,295903
2016/3/11,臺指選擇權,PUT,自營商,150702,233387,156358,206284,-5656,27102,97959,164870,163294,116738,-65335,48132
2016/3/11,臺指選擇權,PUT,投信,0,0,0,0,0,0,370,735,320,1017,50,-282
2016/3/11,臺指選擇權,PUT,外資及陸資,39546,72962,29532,73029,10014,-67,154110,150480,66670,123359,87440,27121
2016/3/14,臺指選擇權,CALL,自營商,102505,283376,110332,293462,-7827,-10086,82514,678610,97976,664383,-15462,14227
2016/3/14,臺指選擇權,CALL,投信,552,943,300,162,252,781,820,6995,880,7768,-60,-773
2016/3/14,臺指選擇權,CALL,外資及陸資,35082,91324,28184,99211,6898,-7887,121605,942482,68791,619745,52814,322737
2016/3/14,臺指選擇權,PUT,自營商,111261,154663,121564,141462,-10303,13201,99959,148180,175597,104778,-75638,43402
2016/3/14,臺指選擇權,PUT,投信,200,1002,0,0,200,1002,498,1258,248,477,250,781
2016/3/14,臺指選擇權,PUT,外資及陸資,26967,59538,25095,44639,1872,14898,157928,148570,68579,114855,89349,33715
2016/3/15,臺指選擇權,CALL,自營商,173039,284862,189926,305517,-16887,-20656,89703,475346,122080,423737,-32377,51609
2016/3/15,臺指選擇權,CALL,投信,0,0,0,0,0,0,820,4761,880,5693,-60,-932
2016/3/15,臺指選擇權,CALL,外資及陸資,36108,84270,30778,63694,5330,20576,127696,642971,69530,411957,58166,231014
2016/3/15,臺指選擇權,PUT,自營商,180968,327117,187994,442950,-7026,-115832,103694,304347,186366,244261,-82672,60086
2016/3/15,臺指選擇權,PUT,投信,0,0,0,0,0,0,498,2170,248,855,250,1315
2016/3/15,臺指選擇權,PUT,外資及陸資,50487,129051,51154,130782,-667,-1731,163069,266675,74394,184632,88675,82043
2016/3/16,臺指選擇權,CALL,自營商,152919,372185,139737,355354,13182,16832,56218,260069,38190,160033,18028,100036
2016/3/16,臺指選擇權,CALL,投信,140,19,100,13,40,7,848,4075,808,4615,40,-540
2016/3/16,臺指選擇權,CALL,外資及陸資,25935,69083,24122,54488,1813,14595,45656,290186,20092,143122,25564,147064
2016/3/16,臺指選擇權,PUT,自營商,134059,188092,154395,260389,-20336,-72297,41362,131410,60669,182093,-19307,-50683
2016/3/16,臺指選擇權,PUT,投信,0,0,0,0,0,0,376,1597,176,625,200,972
2016/3/16,臺指選擇權,PUT,外資及陸資,26758,92806,20465,63560,6293,29246,52688,205545,30764,142917,21924,62628
2016/3/17,臺指選擇權,CALL,自營商,142865,362236,146659,405253,-3794,-43016,65749,283778,51535,202314,14214,81464
2016/3/17,臺指選擇權,CALL,投信,160,50,0,0,160,50,1008,4557,808,4964,200,-407
2016/3/17,臺指選擇權,CALL,外資及陸資,34335,129488,30916,111607,3419,17882,51458,337774,22447,161173,29011,176601
2016/3/17,臺指選擇權,PUT,自營商,144395,293684,133881,313021,10514,-19337,63290,160087,72012,220006,-8722,-59919
2016/3/17,臺指選擇權,PUT,投信,0,0,0,0,0,0,376,1323,176,493,200,830
2016/3/17,臺指選擇權,PUT,外資及陸資,35936,138100,29842,96769,6094,41331,62623,254490,34531,150397,28092,104093
2016/3/18,臺指選擇權,CALL,自營商,93278,226026,98149,250088,-4871,-24063,71278,355967,61951,294808,9327,61159
2016/3/18,臺指選擇權,CALL,投信,100,399,0,0,100,399,1108,5853,808,5753,300,100
2016/3/18,臺指選擇權,CALL,外資及陸資,24239,82536,21899,77050,2340,5485,54313,401120,22899,187680,31414,213440
2016/3/18,臺指選擇權,PUT,自營商,123196,209191,119649,212361,3547,-3170,78817,141131,84029,185642,-5212,-44511
2016/3/18,臺指選擇權,PUT,投信,100,391,0,0,100,391,476,1394,176,348,300,1046
2016/3/18,臺指選擇權,PUT,外資及陸資,31655,79500,27267,70100,4388,9400,69495,223005,37055,128566,32440,94439
2016/3/21,臺指選擇權,CALL,自營商,102015,195490,107116,223542,-5101,-28052,73198,322584,68231,285778,4967,36806
2016/3/21,臺指選擇權,CALL,投信,0,0,0,0,0,0,1108,5384,808,5472,300,-88
2016/3/21,臺指選擇權,CALL,外資及陸資,27024,74329,28349,83845,-1325,-9516,53795,372146,23703,180102,30092,192044
2016/3/21,臺指選擇權,PUT,自營商,121288,228924,110176,202839,11112,26085,90081,159723,84317,182435,5764,-22712
2016/3/21,臺指選擇權,PUT,投信,0,0,0,0,0,0,476,1365,176,334,300,1031
2016/3/21,臺指選擇權,PUT,外資及陸資,29520,75932,26645,75286,2875,646,72820,228579,37487,132588,35333,95991
2016/3/22,臺指選擇權,CALL,自營商,145739,276190,135657,247032,10082,29158,87867,370170,72551,292973,15316,77197
2016/3/22,臺指選擇權,CALL,投信,0,0,0,0,0,0,1108,5290,808,5380,300,-90
2016/3/22,臺指選擇權,CALL,外資及陸資,26543,73589,27096,77736,-553,-4146,54011,371795,24456,185080,29555,186715
2016/3/22,臺指選擇權,PUT,自營商,139288,298403,133463,293733,5825,4670,103348,184445,91880,211851,11468,-27406
2016/3/22,臺指選擇權,PUT,投信,0,0,0,0,0,0,476,1252,176,304,300,948
2016/3/22,臺指選擇權,PUT,外資及陸資,31878,89305,30219,97885,1659,-8580,76377,223804,39395,138271,36982,85533
2016/3/23,臺指選擇權,CALL,自營商,130231,218100,126843,200836,3388,17264,64570,300085,57500,213949,7070,86136
2016/3/23,臺指選擇權,CALL,投信,0,0,0,0,0,0,1108,4704,808,5004,300,-300
2016/3/23,臺指選擇權,CALL,外資及陸資,32085,77070,33211,82315,-1126,-5245,53132,335988,24480,168097,28652,167891
2016/3/23,臺指選擇權,PUT,自營商,135929,221053,140458,215590,-4529,5463,63896,196031,71497,228635,-7601,-32604
2016/3/23,臺指選擇權,PUT,投信,0,0,0,0,0,0,476,1425,176,339,300,1086
2016/3/23,臺指選擇權,PUT,外資及陸資,37173,79802,34724,80947,2449,-1145,71904,247159,39931,154308,31973,92851
2016/3/24,臺指選擇權,CALL,自營商,127802,276264,135742,315011,-7940,-38747,73138,321402,73975,286224,-837,35178
2016/3/24,臺指選擇權,CALL,投信,0,0,0,0,0,0,1108,4711,808,4945,300,-234
2016/3/24,臺指選擇權,CALL,外資及陸資,31707,102592,33632,108103,-1925,-5511,54310,342562,27578,180070,26732,162492
2016/3/24,臺指選擇權,PUT,自營商,144158,271937,129872,285082,14286,-13145,93796,219166,87189,266702,6607,-47536
2016/3/24,臺指選擇權,PUT,投信,0,0,0,0,0,0,476,1367,176,321,300,1046
2016/3/24,臺指選擇權,PUT,外資及陸資,39532,103258,32862,95038,6670,8220,80957,254390,42321,156748,38636,97642
2016/3/25,臺指選擇權,CALL,自營商,111878,190448,113339,233324,-1461,-42876,85498,299912,87865,291864,-2367,8048
2016/3/25,臺指選擇權,CALL,投信,460,116,460,116,0,0,648,4467,348,4671,300,-204
2016/3/25,臺指選擇權,CALL,外資及陸資,21633,63928,22178,69745,-545,-5817,54633,334896,28453,181379,26180,153517
2016/3/25,臺指選擇權,PUT,自營商,117722,222825,109746,216934,7976,5890,111076,249931,96459,299129,14617,-49198
2016/3/25,臺指選擇權,PUT,投信,0,0,0,0,0,0,476,1381,176,326,300,1055
2016/3/25,臺指選擇權,PUT,外資及陸資,23363,61870,23149,66739,214,-4869,82604,264876,43681,167778,38923,97098
2016/3/28,臺指選擇權,CALL,自營商,113354,167703,99013,173402,14341,-5699,105267,296030,93293,283298,11974,12732
2016/3/28,臺指選擇權,CALL,投信,0,0,0,0,0,0,648,4149,348,4495,300,-346
2016/3/28,臺指選擇權,CALL,外資及陸資,22041,54767,22765,68073,-724,-13306,56206,322300,30750,184866,25456,137434
2016/3/28,臺指選擇權,PUT,自營商,101464,176967,97071,178681,4393,-1714,126777,273926,107767,332145,19010,-58219
2016/3/28,臺指選擇權,PUT,投信,0,0,0,0,0,0,476,1446,176,334,300,1112
2016/3/28,臺指選擇權,PUT,外資及陸資,24182,57878,21289,59231,2893,-1354,86014,271159,44198,174136,41816,97023
2016/3/29,臺指選擇權,CALL,自營商,162616,222796,177618,229300,-15002,-6504,102948,234786,105976,190131,-3028,44655
2016/3/29,臺指選擇權,CALL,投信,0,0,0,0,0,0,648,3026,348,3626,300,-600
2016/3/29,臺指選擇權,CALL,外資及陸資,35962,86853,34438,81138,1524,5715,60020,269003,33040,150266,26980,118737
2016/3/29,臺指選擇權,PUT,自營商,159825,350260,162807,339295,-2982,10965,127022,378915,110994,436085,16028,-57170
2016/3/29,臺指選擇權,PUT,投信,0,0,0,0,0,0,476,1962,176,449,300,1513
2016/3/29,臺指選擇權,PUT,外資及陸資,46641,143906,38210,122546,8431,21360,95351,361516,45104,222062,50247,139454
2016/3/30,臺指選擇權,CALL,自營商,183532,309266,167959,293490,15573,15776,72138,346295,73603,268016,-1465,78279
2016/3/30,臺指選擇權,CALL,投信,0,0,0,0,0,0,648,4648,348,5008,300,-360
2016/3/30,臺指選擇權,CALL,外資及陸資,33519,88965,30868,83571,2651,5394,58992,370536,32445,208980,26547,161556
2016/3/30,臺指選擇權,PUT,自營商,161339,224099,207306,290652,-45967,-66554,75861,200793,107913,286659,-32052,-85866
2016/3/30,臺指選擇權,PUT,投信,0,0,0,0,0,0,476,1021,176,233,300,788
2016/3/30,臺指選擇權,PUT,外資及陸資,28995,56290,29267,69110,-272,-12821,90296,238392,47468,155344,42828,83048
2016/3/31,臺指選擇權,CALL,自營商,148269,278928,143204,335452,5065,-56523,91111,319852,87429,267207,3682,52645
2016/3/31,臺指選擇權,CALL,投信,0,0,0,0,0,0,648,4305,348,4747,300,-442
2016/3/31,臺指選擇權,CALL,外資及陸資,35800,100699,33560,102777,2240,-2078,62350,354583,33591,197697,28759,156886
2016/3/31,臺指選擇權,PUT,自營商,145992,266336,127766,241748,18226,24588,98363,234663,112013,299242,-13650,-64579
2016/3/31,臺指選擇權,PUT,投信,0,0,0,0,0,0,476,1106,176,246,300,860
2016/3/31,臺指選擇權,PUT,外資及陸資,46368,100312,33826,95590,12542,4722,105141,257814,49801,170841,55340,86973
2016/4/1,臺指選擇權,CALL,自營商,139751,217673,152074,240724,-12323,-23051,86389,237940,95019,197550,-8630,40390
2016/4/1,臺指選擇權,CALL,投信,0,0,0,0,0,0,648,3118,348,3768,300,-650
2016/4/1,臺指選擇權,CALL,外資及陸資,30135,74782,30079,72198,56,2584,62631,284643,33775,154463,28856,130180
2016/4/1,臺指選擇權,PUT,自營商,146623,343472,138005,283833,8618,59639,105233,324694,110285,352859,-5052,-28165
2016/4/1,臺指選擇權,PUT,投信,0,0,0,0,0,0,476,1544,176,343,300,1201
2016/4/1,臺指選擇權,PUT,外資及陸資,47797,134448,37186,115874,10611,18574,114917,338497,48951,208289,65966,130208
2016/4/6,臺指選擇權,CALL,自營商,172118,257092,203949,272941,-31831,-15849,64691,165789,96864,138218,-32173,27571
2016/4/6,臺指選擇權,CALL,投信,0,0,0,0,0,0,648,1555,348,2219,300,-664
2016/4/6,臺指選擇權,CALL,外資及陸資,37687,89149,42098,88920,-4411,230,63910,196608,38754,110036,25156,86572
2016/4/6,臺指選擇權,PUT,自營商,186473,447573,187395,491985,-922,-44413,85667,459789,99843,529316,-14176,-69527
2016/4/6,臺指選擇權,PUT,投信,0,0,0,0,0,0,476,3090,176,748,300,2342
2016/4/6,臺指選擇權,PUT,外資及陸資,64318,189439,55716,188938,8602,500,114002,569209,53534,347147,60468,222062
2016/4/7,臺指選擇權,CALL,自營商,139368,224975,132068,211447,7300,13528,82207,175591,107124,126839,-24917,48752
2016/4/7,臺指選擇權,CALL,投信,0,0,0,0,0,0,648,1218,348,1875,300,-657
2016/4/7,臺指選擇權,CALL,外資及陸資,30287,81647,30335,73243,-48,8403,68272,190246,43174,102763,25098,87483
2016/4/7,臺指選擇權,PUT,自營商,144142,334602,130856,365636,13286,-31034,104205,445311,105180,546883,-975,-101572
2016/4/7,臺指選擇權,PUT,投信,0,0,0,0,0,0,476,3156,176,704,300,2452
2016/4/7,臺指選擇權,PUT,外資及陸資,36111,135764,30561,133525,5550,2239,122010,576911,56024,356506,65986,220405
2016/4/8,臺指選擇權,CALL,自營商,133975,232076,131065,256536,2910,-24461,96585,216408,118621,184688,-22036,31720
2016/4/8,臺指選擇權,CALL,投信,0,0,0,0,0,0,648,1493,348,2193,300,-700
2016/4/8,臺指選擇權,CALL,外資及陸資,29386,87217,26879,78238,2507,8980,71385,225371,43790,115893,27595,109478
2016/4/8,臺指選擇權,PUT,自營商,154437,255323,152874,288174,1563,-32851,116352,374037,115840,476885,512,-102848
2016/4/8,臺指選擇權,PUT,投信,0,0,0,0,0,0,476,2478,176,510,300,1968
2016/4/8,臺指選擇權,PUT,外資及陸資,38297,105943,30180,88380,8117,17563,130581,498995,56458,300834,74123,198161
2016/4/11,臺指選擇權,CALL,自營商,135941,207390,113086,198566,22855,8824,117881,249818,117068,203890,813,45928
2016/4/11,臺指選擇權,CALL,投信,40,0,40,0,0,0,688,1609,388,2398,300,-789
2016/4/11,臺指選擇權,CALL,外資及陸資,29454,82613,28169,76151,1285,6463,73114,245261,44260,123937,28854,121324
2016/4/11,臺指選擇權,PUT,自營商,128456,196058,134546,218186,-6090,-22128,120064,331994,125641,437822,-5577,-105828
2016/4/11,臺指選擇權,PUT,投信,0,0,0,0,0,0,476,1956,176,365,300,1591
2016/4/11,臺指選擇權,PUT,外資及陸資,31478,73561,32334,78366,-856,-4805,131323,434654,58031,269219,73292,165435
2016/4/12,臺指選擇權,CALL,自營商,143900,229608,145031,221727,-1131,7882,121782,229457,121929,178078,-147,51379
2016/4/12,臺指選擇權,CALL,投信,0,0,0,0,0,0,688,1347,388,2127,300,-780
2016/4/12,臺指選擇權,CALL,外資及陸資,33645,84208,27697,73007,5948,11201,77473,228608,42597,109450,34876,119158
2016/4/12,臺指選擇權,PUT,自營商,166417,258465,170540,253765,-4123,4700,126211,362983,135908,461619,-9697,-98636
2016/4/12,臺指選擇權,PUT,投信,0,0,0,0,0,0,476,2006,176,348,300,1658
2016/4/12,臺指選擇權,PUT,外資及陸資,39017,96068,39811,106633,-794,-10564,135087,459799,62638,301410,72449,158389
2016/4/13,臺指選擇權,CALL,自營商,173346,365545,164452,344728,8894,20817,71761,296447,104523,224866,-32762,71581
2016/4/13,臺指選擇權,CALL,投信,0,0,0,0,0,0,688,2566,388,3584,300,-1018
2016/4/13,臺指選擇權,CALL,外資及陸資,41968,120840,36293,113616,5675,7224,78644,348151,41410,157822,37234,190329
2016/4/13,臺指選擇權,PUT,自營商,171055,213672,208010,225758,-36955,-12086,80846,229172,119463,287356,-38617,-58184
2016/4/13,臺指選擇權,PUT,投信,0,0,0,0,0,0,476,635,176,79,300,556
2016/4/13,臺指選擇權,PUT,外資及陸資,34860,60764,28867,61749,5993,-985,135294,278309,63905,180457,71389,97852
2016/4/14,臺指選擇權,CALL,自營商,116453,194852,117333,278869,-880,-84017,83961,300178,117318,288656,-33357,11522
2016/4/14,臺指選擇權,CALL,投信,0,0,0,0,0,0,688,2707,388,3826,300,-1119
2016/4/14,臺指選擇權,CALL,外資及陸資,28715,86431,30844,97238,-2129,-10806,79464,371077,44275,174100,35189,196977
2016/4/14,臺指選擇權,PUT,自營商,128114,203249,113492,163644,14622,39604,105213,253132,129127,267266,-23914,-14134
2016/4/14,臺指選擇權,PUT,投信,0,0,0,0,0,0,476,437,176,27,300,410
2016/4/14,臺指選擇權,PUT,外資及陸資,33678,62439,24108,66342,9570,-3902,145405,247613,64556,167232,80849,80381
2016/4/15,臺指選擇權,CALL,自營商,120099,236232,108325,236929,11774,-697,93685,356269,115214,367784,-21529,-11515
2016/4/15,臺指選擇權,CALL,投信,0,0,0,0,0,0,688,3360,388,4462,300,-1102
2016/4/15,臺指選擇權,CALL,外資及陸資,24035,74674,20921,68560,3114,6114,82297,444410,44000,205278,38297,239132
2016/4/15,臺指選擇權,PUT,自營商,134400,189933,141929,199730,-7529,-9797,105913,194403,137350,220279,-31437,-25876
2016/4/15,臺指選擇權,PUT,投信,0,0,0,0,0,0,476,176,176,11,300,165
2016/4/15,臺指選擇權,PUT,外資及陸資,28841,45938,18723,47654,10118,-1716,156257,199741,65275,139179,90982,60562
2016/4/18,臺指選擇權,CALL,自營商,107799,140576,108113,183358,-314,-42782,103640,272394,125552,275640,-21912,-3246
2016/4/18,臺指選擇權,CALL,投信,0,0,0,0,0,0,688,2410,388,3581,300,-1171
2016/4/18,臺指選擇權,CALL,外資及陸資,19778,44330,22831,43718,-3053,612,84693,351094,49632,161841,35061,189253
2016/4/18,臺指選擇權,PUT,自營商,102645,159500,95746,141479,6899,18021,118828,281685,143172,286521,-24344,-4836
2016/4/18,臺指選擇權,PUT,投信,0,0,0,0,0,0,476,303,176,15,300,288
2016/4/18,臺指選擇權,PUT,外資及陸資,18340,36122,22693,41065,-4353,-4943,158465,256644,71692,184044,86773,72600
2016/4/19,臺指選擇權,CALL,自營商,164978,295544,175918,288308,-10940,7236,100226,256450,133027,257568,-32801,-1118
2016/4/19,臺指選擇權,CALL,投信,1000,142,1000,134,0,8,1688,2400,1388,3590,300,-1190
2016/4/19,臺指選擇權,CALL,外資及陸資,38757,91362,38283,88663,474,2700,84711,331456,49142,151323,35569,180133
2016/4/19,臺指選擇權,PUT,自營商,178177,278013,177565,266017,612,11996,124049,300559,147787,306493,-23738,-5934
2016/4/19,臺指選擇權,PUT,投信,0,0,0,0,0,0,476,205,176,4,300,201
2016/4/19,臺指選擇權,PUT,外資及陸資,34850,82826,34496,85460,354,-2634,162184,270020,75087,202021,87097,67999
2016/4/20,臺指選擇權,CALL,自營商,236929,345294,268799,336269,-31870,9026,53856,142009,48373,95277,5483,46732
2016/4/20,臺指選擇權,CALL,投信,0,0,0,0,0,0,1040,107,1040,107,0,0
2016/4/20,臺指選擇權,CALL,外資及陸資,42586,79637,41895,82784,691,-3147,57455,176993,28028,84830,29427,92163
2016/4/20,臺指選擇權,PUT,自營商,247489,544669,275366,624711,-27877,-80041,58800,284770,65735,338055,-6935,-53285
2016/4/20,臺指選擇權,PUT,投信,0,0,0,0,0,0,0,0,0,0,0,0
2016/4/20,臺指選擇權,PUT,外資及陸資,51984,121018,52428,167770,-444,-46753,47696,313938,46484,316511,1212,-2573
2016/4/21,臺指選擇權,CALL,自營商,105578,231476,89828,197989,15750,33487,74731,238880,53358,154751,21373,84129
2016/4/21,臺指選擇權,CALL,投信,0,0,0,0,0,0,1040,84,1040,84,0,0
2016/4/21,臺指選擇權,CALL,外資及陸資,24489,71744,26312,80420,-1823,-8676,59445,213248,31799,117190,27646,96058
2016/4/21,臺指選擇權,PUT,自營商,108197,210146,99364,237494,8833,-27348,81292,214241,79417,271013,1875,-56772
2016/4/21,臺指選擇權,PUT,投信,0,0,0,0,0,0,0,0,0,0,0,0
2016/4/21,臺指選擇權,PUT,外資及陸資,24423,71607,22254,79069,2169,-7461,52588,244201,49184,244106,3404,95
2016/4/22,臺指選擇權,CALL,自營商,107841,227829,117477,229679,-9636,-1850,73400,220379,61716,151504,11684,68875
2016/4/22,臺指選擇權,CALL,投信,0,0,0,0,0,0,1040,66,1040,66,0,0
2016/4/22,臺指選擇權,CALL,外資及陸資,29101,77852,29752,77353,-651,499,61332,195126,34369,106461,26963,88665
2016/4/22,臺指選擇權,PUT,自營商,120116,224216,111980,207935,8136,16282,97891,240754,87900,291544,9991,-50790
2016/4/22,臺指選擇權,PUT,投信,0,0,0,0,0,0,0,0,0,0,0,0
2016/4/22,臺指選擇權,PUT,外資及陸資,28218,70812,27442,72355,776,-1543,55067,260492,50835,263226,4232,-2734
2016/4/25,臺指選擇權,CALL,自營商,89416,144795,68885,115263,20531,29532,95360,268715,63087,166464,32273,102251
2016/4/25,臺指選擇權,CALL,投信,0,0,0,0,0,0,1040,48,1040,48,0,0
2016/4/25,臺指選擇權,CALL,外資及陸資,19010,45436,18992,50295,18,-4859,63901,204387,36904,118845,26997,85542
2016/4/25,臺指選擇權,PUT,自營商,81830,140128,88487,167366,-6657,-27238,109055,224191,105746,288097,3309,-63906
2016/4/25,臺指選擇權,PUT,投信,0,0,0,0,0,0,0,0,0,0,0,0
2016/4/25,臺指選擇權,PUT,外資及陸資,21730,51041,19978,54864,1752,-3823,58766,235813,52809,236563,5957,-750
2016/4/26,臺指選擇權,CALL,自營商,124132,257274,120294,213418,3838,43856,105011,341406,68861,190243,36150,151163
2016/4/26,臺指選擇權,CALL,投信,200,657,0,0,200,657,1240,651,1040,51,200,600
2016/4/26,臺指選擇權,CALL,外資及陸資,30741,92324,30464,91464,277,860,65783,236287,38477,143930,27306,92357
2016/4/26,臺指選擇權,PUT,自營商,138830,232789,147593,240107,-8763,-7318,118888,217237,124362,266572,-5474,-49335
2016/4/26,臺指選擇權,PUT,投信,200,802,0,0,200,802,200,880,0,0,200,880
2016/4/26,臺指選擇權,PUT,外資及陸資,35346,87261,31719,89800,3627,-2538,63842,218659,54295,213386,9547,5273
2016/4/27,臺指選擇權,CALL,自營商,129750,192389,146742,218494,-16992,-26105,69009,268974,52838,164711,16171,104263
2016/4/27,臺指選擇權,CALL,投信,0,0,0,0,0,0,1240,588,1040,48,200,540
2016/4/27,臺指選擇權,CALL,外資及陸資,26559,57100,26817,60741,-258,-3641,65778,220773,39303,136200,26475,84573
2016/4/27,臺指選擇權,PUT,自營商,139383,219375,145365,192275,-5982,27100,82488,215419,91006,245355,-8518,-29936
2016/4/27,臺指選擇權,PUT,投信,0,0,0,0,0,0,200,910,0,0,200,910
2016/4/27,臺指選擇權,PUT,外資及陸資,29750,64271,26241,60175,3509,4097,59294,227499,54843,219657,4451,7842
2016/4/28,臺指選擇權,CALL,自營商,146521,253215,174988,308636,-28467,-55422,68588,184426,80869,130435,-12281,53991
2016/4/28,臺指選擇權,CALL,投信,0,0,0,0,0,0,1240,207,1040,27,200,180
2016/4/28,臺指選擇權,CALL,外資及陸資,40967,109858,44221,131759,-3254,-21901,65664,139139,42404,89285,23260,49854
2016/4/28,臺指選擇權,PUT,自營商,165956,357767,153811,316009,12145,41759,96344,368651,92727,358563,3617,10088
2016/4/28,臺指選擇權,PUT,投信,0,0,0,0,0,0,200,1570,0,0,200,1570
2016/4/28,臺指選擇權,PUT,外資及陸資,54241,172207,41114,149326,13127,22880,72543,355450,54988,335407,17555,20043
2016/4/29,臺指選擇權,CALL,自營商,149485,226194,175331,218914,-25846,7280,71890,155182,110032,107975,-38142,47207
2016/4/29,臺指選擇權,CALL,投信,100,340,0,0,100,340,1340,430,1040,35,300,395
2016/4/29,臺指選擇權,CALL,外資及陸資,31238,73349,26220,56430,5018,16919,71039,116395,42749,57665,28290,58730
2016/4/29,臺指選擇權,PUT,自營商,147353,347766,145124,334220,2229,13546,105349,507259,99541,473116,5808,34143
2016/4/29,臺指選擇權,PUT,投信,100,413,0,0,100,413,300,2650,0,0,300,2650
2016/4/29,臺指選擇權,PUT,外資及陸資,44496,150421,33141,139632,11355,10789,84330,469876,55400,440592,28930,29284
2016/5/3,臺指選擇權,CALL,自營商,135026,167902,163938,171563,-28912,-3661,71887,130435,138968,91252,-67081,39183
2016/5/3,臺指選擇權,CALL,投信,0,0,0,0,0,0,1340,257,1040,36,300,221
2016/5/3,臺指選擇權,CALL,外資及陸資,35074,79597,37229,73969,-2155,5628,75830,106961,49708,51713,26122,55248
2016/5/3,臺指選擇權,PUT,自營商,126945,287555,117771,239566,9174,47988,110821,576798,95832,490094,14989,86704
2016/5/3,臺指選擇權,PUT,投信,0,0,0,0,0,0,300,3023,0,0,300,3023
2016/5/3,臺指選擇權,PUT,外資及陸資,42759,137861,37377,126537,5382,11324,90670,511690,56333,477502,34337,34188
2016/5/4,臺指選擇權,CALL,自營商,206800,260291,238059,242484,-31259,17808,69768,147315,106857,103024,-37089,44291
2016/5/4,臺指選擇權,CALL,投信,0,0,0,0,0,0,1340,144,1040,28,300,116
2016/5/4,臺指選擇權,CALL,外資及陸資,43437,105774,40182,92166,3255,13608,81150,110773,49728,46705,31422,64068
2016/5/4,臺指選擇權,PUT,自營商,222725,511373,233152,519518,-10427,-8145,92021,584046,84646,490397,7375,93649
2016/5/4,臺指選擇權,PUT,投信,0,0,0,0,0,0,300,3943,0,0,300,3943
2016/5/4,臺指選擇權,PUT,外資及陸資,62674,210954,55707,223639,6967,-12685,86679,580374,57694,585529,28985,-5155
2016/5/5,臺指選擇權,CALL,自營商,126537,183080,137527,195108,-10990,-12028,80171,142284,128336,113725,-48165,28559
2016/5/5,臺指選擇權,CALL,投信,0,0,0,0,0,0,1340,117,1040,30,300,87
2016/5/5,臺指選擇權,CALL,外資及陸資,30599,82648,30142,78919,457,3729,83389,108646,51518,47059,31871,61587
2016/5/5,臺指選擇權,PUT,自營商,132380,295808,124006,266171,8374,29636,110757,662245,95142,524779,15615,137466
2016/5/5,臺指選擇權,PUT,投信,0,0,0,0,0,0,300,4358,0,0,300,4358
2016/5/5,臺指選擇權,PUT,外資及陸資,41098,146542,35840,136944,5258,9598,91166,614695,56927,618536,34239,-3841
2016/5/6,臺指選擇權,CALL,自營商,118403,181269,121432,170707,-3029,10562,88364,143689,139705,107146,-51341,36543
2016/5/6,臺指選擇權,CALL,投信,160,2,160,2,0,0,1340,71,1040,18,300,53
2016/5/6,臺指選擇權,CALL,外資及陸資,33400,84822,31927,76356,1473,8467,86725,104263,53370,42149,33355,62114
2016/5/6,臺指選擇權,PUT,自營商,112514,257043,121661,284714,-9147,-27671,114914,729309,108556,603782,6358,125527
2016/5/6,臺指選擇權,PUT,投信,0,0,0,0,0,0,300,4895,0,0,300,4895
2016/5/6,臺指選擇權,PUT,外資及陸資,39877,155371,36882,145171,2995,10200,95145,687854,57904,682360,37241,5494
2016/5/9,臺指選擇權,CALL,自營商,101069,145829,108942,149966,-7873,-4137,88608,145475,147633,109732,-59025,35743
2016/5/9,臺指選擇權,CALL,投信,200,2,200,2,0,0,1540,61,1240,22,300,39
2016/5/9,臺指選擇權,CALL,外資及陸資,32322,72197,34870,77934,-2548,-5737,85999,102239,55202,45530,30797,56709
2016/5/9,臺指選擇權,PUT,自營商,103604,211561,97888,195906,5716,15655,120520,694137,108286,555665,12234,138472
2016/5/9,臺指選擇權,PUT,投信,0,0,0,0,0,0,300,4678,0,0,300,4678
2016/5/9,臺指選擇權,PUT,外資及陸資,37342,120707,38691,127815,-1349,-7107,97612,657731,61728,667896,35884,-10165
2016/5/10,臺指選擇權,CALL,自營商,150981,220209,147393,238968,3588,-18759,98861,184555,154249,157335,-55388,27220
2016/5/10,臺指選擇權,CALL,投信,0,0,0,0,0,0,1540,65,1240,30,300,35
2016/5/10,臺指選擇權,CALL,外資及陸資,42024,119923,41950,107551,74,12372,89128,136182,58255,63622,30873,72560
2016/5/10,臺指選擇權,PUT,自營商,140048,239931,142513,282311,-2465,-42380,124176,633984,114370,540785,9806,93199
2016/5/10,臺指選擇權,PUT,投信,0,0,0,0,0,0,300,4145,0,0,300,4145
2016/5/10,臺指選擇權,PUT,外資及陸資,44038,169087,45618,141178,-1580,27910,99488,638754,65220,622111,34268,16643
2016/5/11,臺指選擇權,CALL,自營商,168755,208655,193404,235174,-24649,-26519,67407,139532,134481,140211,-67074,-679
2016/5/11,臺指選擇權,CALL,投信,0,0,0,0,0,0,1540,35,1240,17,300,18
2016/5/11,臺指選擇權,CALL,外資及陸資,44631,105942,43839,111049,792,-5106,92763,138563,60807,73525,31956,65038
2016/5/11,臺指選擇權,PUT,自營商,178960,258478,174528,258267,4432,211,97826,655722,83946,543579,13880,112143
2016/5/11,臺指選擇權,PUT,投信,0,0,0,0,0,0,300,4448,0,0,300,4448
2016/5/11,臺指選擇權,PUT,外資及陸資,50865,165258,47969,170265,2896,-5007,100838,725580,66457,721004,34381,4576
2016/5/12,臺指選擇權,CALL,自營商,107570,173345,94686,143593,12884,29752,81656,142937,135900,120791,-54244,22146
2016/5/12,臺指選擇權,CALL,投信,0,0,0,0,0,0,1540,30,1240,22,300,8
2016/5/12,臺指選擇權,CALL,外資及陸資,33673,87747,32053,83614,1620,4133,97219,133006,63627,70035,33592,62971
2016/5/12,臺指選擇權,PUT,自營商,113791,201540,128264,264792,-14473,-63252,103193,720245,103979,662712,-786,57533
2016/5/12,臺指選擇權,PUT,投信,0,0,0,0,0,0,300,5045,0,0,300,5045
2016/5/12,臺指選擇權,PUT,外資及陸資,52393,125232,51972,153191,421,-27959,110781,793599,75999,825829,34782,-32230
2016/5/13,臺指選擇權,CALL,自營商,152882,210964,162229,181096,-9347,29868,94867,154020,158647,110788,-63780,43232
2016/5/13,臺指選擇權,CALL,投信,0,0,0,0,0,0,1540,34,1240,28,300,6
2016/5/13,臺指選擇權,CALL,外資及陸資,41155,88006,38968,79762,2187,8244,101462,119874,65716,55884,35746,63990
2016/5/13,臺指選擇權,PUT,自營商,156805,370363,159707,381811,-2902,-11448,106244,829301,109941,773109,-3697,56192
2016/5/13,臺指選擇權,PUT,投信,0,0,0,0,0,0,300,5915,0,0,300,5915
2016/5/13,臺指選擇權,PUT,外資及陸資,54239,180910,49984,204774,4255,-23863,116648,896469,77531,969774,39117,-73305
2016/5/16,臺指選擇權,CALL,自營商,100262,144628,92511,136502,7751,8127,104318,191594,160366,125756,-56048,65838
2016/5/16,臺指選擇權,CALL,投信,0,0,0,0,0,0,1540,26,1240,22,300,4
2016/5/16,臺指選擇權,CALL,外資及陸資,37347,89614,32160,75570,5187,14044,106890,148555,65937,63353,40953,85202
2016/5/16,臺指選擇權,PUT,自營商,105899,160712,115807,190860,-9908,-30148,112148,728628,125972,675849,-13824,52779
2016/5/16,臺指選擇權,PUT,投信,0,0,0,0,0,0,300,5283,0,0,300,5283
2016/5/16,臺指選擇權,PUT,外資及陸資,37058,91123,38258,103859,-1200,-12736,116778,810382,78890,883499,37888,-73117
2016/5/17,臺指選擇權,CALL,自營商,146578,243979,146599,259671,-21,-15693,108036,289179,164117,192569,-56081,96610
2016/5/17,臺指選擇權,CALL,投信,20,12,20,43,0,-31,1540,29,1240,26,300,3
2016/5/17,臺指選擇權,CALL,外資及陸資,42121,104520,42826,108705,-705,-4184,110193,199322,69964,95001,40229,104321
2016/5/17,臺指選擇權,PUT,自營商,152065,215224,149046,215869,3019,-645,119329,577495,130087,523363,-10758,54132
2016/5/17,臺指選擇權,PUT,投信,0,0,0,0,0,0,300,4093,0,0,300,4093
2016/5/17,臺指選擇權,PUT,外資及陸資,34464,89502,33255,83719,1209,5783,118370,677812,79197,711881,39173,-34069
2016/5/18,臺指選擇權,CALL,自營商,177607,332100,197389,372156,-19782,-40056,53240,166957,44667,141244,8573,25713
2016/5/18,臺指選擇權,CALL,投信,0,0,0,0,0,0,1240,12,1240,12,0,0
2016/5/18,臺指選擇權,CALL,外資及陸資,42283,100052,39032,107722,3251,-7669,80818,195739,41469,99809,39349,95930
2016/5/18,臺指選擇權,PUT,自營商,165985,285231,181731,297209,-15746,-11978,53865,291235,68062,294858,-14197,-3623
2016/5/18,臺指選擇權,PUT,投信,0,0,0,0,0,0,0,0,0,0,0,0
2016/5/18,臺指選擇權,PUT,外資及陸資,37167,88100,39652,110043,-2485,-21944,55466,402138,55474,399142,-8,2996
2016/5/19,臺指選擇權,CALL,自營商,103046,212547,108506,243375,-5460,-30829,71029,164008,68048,156939,2981,7069
2016/5/19,臺指選擇權,CALL,投信,0,0,0,0,0,0,1240,19,1240,19,0,0
2016/5/19,臺指選擇權,CALL,外資及陸資,33066,104104,39851,129297,-6785,-25193,83464,164678,50923,107775,32541,56903
2016/5/19,臺指選擇權,PUT,自營商,117763,297218,116886,300080,877,-2862,77866,404966,91109,423483,-13243,-18517
2016/5/19,臺指選擇權,PUT,投信,0,0,0,0,0,0,0,0,0,0,0,0
2016/5/19,臺指選擇權,PUT,外資及陸資,44681,149207,38820,158709,5861,-9502,68376,496356,62450,522111,5926,-25755
2016/5/20,臺指選擇權,CALL,自營商,132335,291869,123376,268211,8959,23658,86837,241121,74925,214700,11912,26421
2016/5/20,臺指選擇權,CALL,投信,0,0,0,0,0,0,1240,15,1240,15,0,0
2016/5/20,臺指選擇權,CALL,外資及陸資,47427,147407,43043,149878,4384,-2471,88888,194955,51900,133839,36988,61116
2016/5/20,臺指選擇權,PUT,自營商,161786,302786,171880,369887,-10094,-67101,100280,339089,123797,385665,-23517,-46576
2016/5/20,臺指選擇權,PUT,投信,0,0,0,0,0,0,0,0,0,0,0,0
2016/5/20,臺指選擇權,PUT,外資及陸資,53976,139389,58797,169783,-4821,-30394,70801,425313,69740,453943,1061,-28630
2016/5/23,臺指選擇權,CALL,自營商,223025,556100,233187,605059,-10162,-48959,83021,507003,81220,463525,1801,43478
2016/5/23,臺指選擇權,CALL,投信,0,0,0,0,0,0,1240,13,1240,13,0,0
2016/5/23,臺指選擇權,CALL,外資及陸資,88773,339514,71550,309120,17223,30394,105739,462475,51530,262948,54209,199527
2016/5/23,臺指選擇權,PUT,自營商,248186,376386,264535,377401,-16349,-1015,109575,206401,149306,199827,-39731,6574
2016/5/23,臺指選擇權,PUT,投信,0,0,0,0,0,0,0,0,0,0,0,0
2016/5/23,臺指選擇權,PUT,外資及陸資,60627,150935,53403,128523,7224,22411,79855,302977,71547,259446,8308,43531
2016/5/24,臺指選擇權,CALL,自營商,102091,172669,108650,185061,-6559,-12392,87671,402832,92375,368154,-4704,34678
2016/5/24,臺指選擇權,CALL,投信,0,0,0,0,0,0,1240,11,1240,11,0,0
2016/5/24,臺指選擇權,CALL,外資及陸資,28296,84920,32584,103578,-4288,-18658,103669,345398,53775,219493,49894,125905
2016/5/24,臺指選擇權,PUT,自營商,123484,182865,126674,177359,-3190,5506,116798,248010,159613,230744,-42815,17266
2016/5/24,臺指選擇權,PUT,投信,0,0,0,0,0,0,0,0,0,0,0,0
2016/5/24,臺指選擇權,PUT,外資及陸資,25654,50099,21070,45957,4584,4143,81640,328204,68691,285933,12949,42271
2016/5/25,臺指選擇權,CALL,自營商,154271,312595,152619,278476,1652,34119,72196,382397,65691,351289,6505,31108
2016/5/25,臺指選擇權,CALL,投信,0,0,0,0,0,0,1240,10,1240,10,0,0
2016/5/25,臺指選擇權,CALL,外資及陸資,49725,138342,45612,141701,4113,-3359,99365,422053,52155,271183,47210,150870
2016/5/25,臺指選擇權,PUT,自營商,163611,176050,192378,195602,-28767,-19553,71838,176147,99218,188431,-27380,-12284
2016/5/25,臺指選擇權,PUT,投信,0,0,0,0,0,0,0,0,0,0,0,0
2016/5/25,臺指選擇權,PUT,外資及陸資,41435,71956,34919,66799,6516,5157,77065,268141,61259,208800,15806,59341
2016/5/26,臺指選擇權,CALL,自營商,61837,117529,63081,118720,-1244,-1191,77035,377307,71777,348597,5258,28710
2016/5/26,臺指選擇權,CALL,投信,200,500,0,0,200,500,1440,481,1240,6,200,475
2016/5/26,臺指選擇權,CALL,外資及陸資,17645,61163,19455,62953,-1810,-1791,97346,411437,51936,267432,45410,144005
2016/5/26,臺指選擇權,PUT,自營商,74392,106572,76567,118756,-2175,-12184,82283,183517,111815,206323,-29532,-22806
2016/5/26,臺指選擇權,PUT,投信,200,460,0,0,200,460,200,435,0,0,200,435
2016/5/26,臺指選擇權,PUT,外資及陸資,28325,51858,18794,51255,9531,603,86703,265911,61344,206764,25359,59147
2016/5/27,臺指選擇權,CALL,自營商,100710,230441,94483,213046,6227,17395,89744,484590,78080,437596,11664,46994
2016/5/27,臺指選擇權,CALL,投信,0,0,0,0,0,0,1440,750,1240,10,200,740
2016/5/27,臺指選擇權,CALL,外資及陸資,30455,99046,28314,105036,2141,-5990,100904,513157,53303,335063,47601,178094
2016/5/27,臺指選擇權,PUT,自營商,103957,161750,113649,176525,-9692,-14775,87720,160520,126964,180545,-39244,-20025
2016/5/27,臺指選擇權,PUT,投信,0,0,0,0,0,0,200,265,0,0,200,265
2016/5/27,臺指選擇權,PUT,外資及陸資,29869,70004,25399,71770,4470,-1766,94541,240102,64762,184071,29779,56031
2016/5/30,臺指選擇權,CALL,自營商,127761,243521,136833,267027,-9072,-23506,90173,551977,87436,529240,2737,22737
2016/5/30,臺指選擇權,CALL,投信,0,0,0,0,0,0,1440,995,1240,15,200,980
2016/5/30,臺指選擇權,CALL,外資及陸資,43971,135863,44433,142768,-462,-6905,103167,595693,56004,394965,47163,200728
2016/5/30,臺指選擇權,PUT,自營商,146699,183593,155115,194957,-8416,-11363,99011,160464,146691,169927,-47680,-9463
2016/5/30,臺指選擇權,PUT,投信,0,0,0,0,0,0,200,190,0,0,200,190
2016/5/30,臺指選擇權,PUT,外資及陸資,39526,76782,37612,83815,1914,-7033,99277,221749,67601,172692,31676,49057
2016/5/31,臺指選擇權,CALL,自營商,150248,286173,148533,256915,1715,29258,97036,555708,92640,512697,4396,43011
2016/5/31,臺指選擇權,CALL,投信,0,0,0,0,0,0,1440,990,1240,10,200,980
2016/5/31,臺指選擇權,CALL,外資及陸資,42284,123737,40608,123614,1676,124,105377,597282,56525,394831,48852,202451
2016/5/31,臺指選擇權,PUT,自營商,148917,183218,143453,175669,5464,7549,110333,167553,152540,167832,-42207,-279
2016/5/31,臺指選擇權,PUT,投信,0,0,0,0,0,0,200,175,0,0,200,175
2016/5/31,臺指選擇權,PUT,外資及陸資,37335,74201,35870,82455,1465,-8254,102087,215346,68940,171964,33147,43382
2016/6/1,臺指選擇權,CALL,自營商,175172,349001,170204,312812,4968,36189,75238,572512,76774,523848,-1536,48664
2016/6/1,臺指選擇權,CALL,投信,400,866,200,1075,200,-209,1640,952,1240,12,400,940
2016/6/1,臺指選擇權,CALL,外資及陸資,53935,157295,49171,154042,4764,3253,106517,674965,55939,442552,50578,232413
2016/6/1,臺指選擇權,PUT,自營商,179149,176521,209033,217894,-29884,-41373,85677,138979,127194,162733,-41517,-23754
2016/6/1,臺指選擇權,PUT,投信,200,220,0,0,200,220,400,320,0,0,400,320
2016/6/1,臺指選擇權,PUT,外資及陸資,41347,76270,39229,79743,2118,-3473,96973,200046,68878,155897,28095,44149
2016/6/2,臺指選擇權,CALL,自營商,108645,212452,119072,244714,-10427,-32263,80693,563732,92709,540881,-12016,22851
2016/6/2,臺指選擇權,CALL,投信,0,0,0,0,0,0,1640,870,1240,10,400,860
2016/6/2,臺指選擇權,CALL,外資及陸資,36201,103600,36507,121678,-306,-18078,108656,650545,58387,442449,50269,208096
2016/6/2,臺指選擇權,PUT,自營商,125045,199425,128425,214916,-3380,-15491,101598,170282,146512,212657,-44914,-42375
2016/6/2,臺指選擇權,PUT,投信,0,0,0,0,0,0,400,320,0,0,400,320
2016/6/2,臺指選擇權,PUT,外資及陸資,41506,93667,35891,99813,5615,-6146,107683,218572,73994,180661,33689,37911
2016/6/3,臺指選擇權,CALL,自營商,62666,103493,62364,109769,302,-6275,86972,587745,98584,570414,-11612,17331
2016/6/3,臺指選擇權,CALL,投信,0,0,0,0,0,0,1640,918,1240,8,400,910
2016/6/3,臺指選擇權,CALL,外資及陸資,19361,54511,19085,57439,276,-2929,109958,677213,59368,462396,50590,214817
2016/6/3,臺指選擇權,PUT,自營商,84793,111931,80312,112854,4481,-923,111790,167170,152269,203092,-40479,-35922
2016/6/3,臺指選擇權,PUT,投信,0,0,0,0,0,0,400,233,0,0,400,233
2016/6/3,臺指選擇權,PUT,外資及陸資,25662,56495,23047,61206,2615,-4711,115779,216774,79486,181672,36293,35102
2016/6/4,臺指選擇權,CALL,自營商,35613,58232,31093,55575,4520,2657,90577,590463,97550,567382,-6973,23081
2016/6/4,臺指選擇權,CALL,投信,0,0,0,0,0,0,1640,825,1240,10,400,815
2016/6/4,臺指選擇權,CALL,外資及陸資,4405,16860,4301,16718,104,143,109854,683589,59132,467634,50722,215955
2016/6/4,臺指選擇權,PUT,自營商,49095,57791,45866,51116,3229,6675,111918,151325,149352,169786,-37434,-18461
2016/6/4,臺指選擇權,PUT,投信,0,0,0,0,0,0,400,169,0,0,400,169
2016/6/4,臺指選擇權,PUT,外資及陸資,5650,11227,4546,11163,1104,65,117106,199865,79797,164137,37309,35728
2016/6/6,臺指選擇權,CALL,自營商,113126,193888,122264,201736,-9138,-7847,90566,579491,106677,562624,-16111,16867
2016/6/6,臺指選擇權,CALL,投信,0,0,0,0,0,0,1640,745,1240,10,400,735
2016/6/6,臺指選擇權,CALL,外資及陸資,38252,102391,34324,99320,3928,3072,114829,671076,60179,460657,54650,210419
2016/6/6,臺指選擇權,PUT,自營商,128892,204746,133268,185072,-4376,19674,112285,172279,154095,171093,-41810,1186
2016/6/6,臺指選擇權,PUT,投信,0,0,0,0,0,0,400,150,0,0,400,150
2016/6/6,臺指選擇權,PUT,外資及陸資,41007,97113,33002,92587,8005,4526,124089,209827,78775,168499,45314,41328
2016/6/7,臺指選擇權,CALL,自營商,142008,321972,131220,302429,10788,19543,104820,785893,109705,769034,-4885,16859
2016/6/7,臺指選擇權,CALL,投信,0,0,0,0,0,0,1640,1406,1240,11,400,1395
2016/6/7,臺指選擇權,CALL,外資及陸資,44613,148880,39754,140366,4859,8514,120249,873859,60721,582453,59528,291406
2016/6/7,臺指選擇權,PUT,自營商,149050,178948,169220,182028,-20170,-3081,117101,140212,179163,131849,-62062,8363
2016/6/7,臺指選擇權,PUT,投信,0,0,0,0,0,0,400,77,0,0,400,77
2016/6/7,臺指選擇權,PUT,外資及陸資,36205,67293,32355,69219,3850,-1926,132334,178963,83142,136831,49192,42132
2016/6/8,臺指選擇權,CALL,自營商,165617,350209,176722,363628,-11105,-13419,75515,814315,93351,830954,-17836,-16639
2016/6/8,臺指選擇權,CALL,投信,0,0,0,0,0,0,1640,1921,1240,11,400,1910
2016/6/8,臺指選擇權,CALL,外資及陸資,53857,153263,51484,157665,2373,-4402,117386,968894,59699,636189,57687,332705
2016/6/8,臺指選擇權,PUT,自營商,184075,207777,202880,192615,-18805,15162,88276,128800,145189,118479,-56913,10321
2016/6/8,臺指選擇權,PUT,投信,0,0,0,0,0,0,400,48,0,0,400,48
2016/6/8,臺指選擇權,PUT,外資及陸資,45732,78285,41000,77338,4732,947,131352,164830,84617,126900,46735,37930
2016/6/13,臺指選擇權,CALL,自營商,117558,177371,135576,214366,-18018,-36995,71901,473636,107718,477466,-35817,-3830
2016/6/13,臺指選擇權,CALL,投信,0,0,400,352,-400,-352,1000,5,1000,5,0,0
2016/6/13,臺指選擇權,CALL,外資及陸資,38440,97246,37080,93605,1360,3641,118774,577026,59701,394853,59073,182173
2016/6/13,臺指選擇權,PUT,自營商,148857,311618,145801,361094,3056,-49476,94325,266860,148178,261594,-53853,5266
2016/6/13,臺指選擇權,PUT,投信,0,0,400,116,-400,-116,0,0,0,0,0,0
2016/6/13,臺指選擇權,PUT,外資及陸資,68865,204675,52974,193895,15891,10780,144429,295831,81835,225566,62594,70265
2016/6/14,臺指選擇權,CALL,自營商,104302,161808,97227,161407,7075,401,78328,540123,107078,559270,-28750,-19147
2016/6/14,臺指選擇權,CALL,投信,0,0,0,0,0,0,1000,5,1000,5,0,0
2016/6/14,臺指選擇權,CALL,外資及陸資,30666,83896,28533,74050,2133,9847,120804,674231,59634,449500,61170,224731
2016/6/14,臺指選擇權,PUT,自營商,134584,186620,133173,210967,1411,-24348,106514,213398,158973,221814,-52459,-8416
2016/6/14,臺指選擇權,PUT,投信,0,0,0,0,0,0,0,0,0,0,0,0
2016/6/14,臺指選擇權,PUT,外資及陸資,48127,104858,34379,91033,13748,13826,161736,268400,85352,198294,76384,70106
2016/6/15,臺指選擇權,CALL,自營商,184032,351173,196292,323518,-12260,27655,43862,227114,30404,156836,13458,70278
2016/6/15,臺指選擇權,CALL,投信,500,91,500,91,0,0,500,90,500,90,0,0
2016/6/15,臺指選擇權,CALL,外資及陸資,53511,141002,53339,141433,172,-430,63361,327135,28304,159852,35057,167283
2016/6/15,臺指選擇權,PUT,自營商,177644,254045,177966,282478,-322,-28433,39582,126210,42423,194826,-2841,-68616
2016/6/15,臺指選擇權,PUT,投信,0,0,0,0,0,0,0,0,0,0,0,0
2016/6/15,臺指選擇權,PUT,外資及陸資,63136,141455,44934,128290,18202,13165,60831,271223,29162,197041,31669,74182
2016/6/16,臺指選擇權,CALL,自營商,136902,251492,129157,263181,7745,-11689,75141,214000,53991,156037,21150,57963
2016/6/16,臺指選擇權,CALL,投信,300,32,300,32,0,0,800,111,800,111,0,0
2016/6/16,臺指選擇權,CALL,外資及陸資,42607,112851,37359,117098,5248,-4246,71895,260544,31543,135543,40352,125001
2016/6/16,臺指選擇權,PUT,自營商,130398,325230,140620,383240,-10222,-58010,70097,249528,83168,425455,-13071,-175927
2016/6/16,臺指選擇權,PUT,投信,0,0,0,0,0,0,0,0,0,0,0,0
2016/6/16,臺指選擇權,PUT,外資及陸資,56027,182006,42651,164238,13376,17768,75598,378883,30512,261189,45086,117694
2016/6/17,臺指選擇權,CALL,自營商,100093,242825,87330,205600,12763,37225,88723,321278,54795,214642,33928,106636
2016/6/17,臺指選擇權,CALL,投信,0,0,0,0,0,0,800,139,800,139,0,0
2016/6/17,臺指選擇權,CALL,外資及陸資,29739,122085,25369,107158,4370,14927,74499,339430,29766,167648,44733,171782
2016/6/17,臺指選擇權,PUT,自營商,116009,215220,114654,229717,1355,-14497,87014,201456,98641,309706,-11627,-108250
2016/6/17,臺指選擇權,PUT,投信,0,0,0,0,0,0,0,0,0,0,0,0
2016/6/17,臺指選擇權,PUT,外資及陸資,35491,81992,28259,81293,7232,699,83449,299890,31104,212706,52345,87184
2016/6/20,臺指選擇權,CALL,自營商,107664,223673,116788,264466,-9124,-40792,90079,408362,65151,303336,24928,105026
2016/6/20,臺指選擇權,CALL,投信,845,152,860,150,-15,2,1645,292,1660,293,-15,-1
2016/6/20,臺指選擇權,CALL,外資及陸資,35382,115030,32725,115053,2657,-23,79072,418999,31652,207748,47420,211251
2016/6/20,臺指選擇權,PUT,自營商,118751,197811,113892,203168,4859,-5357,108052,182698,114772,262905,-6720,-80207
2016/6/20,臺指選擇權,PUT,投信,0,0,0,0,0,0,0,0,0,0,0,0
2016/6/20,臺指選擇權,PUT,外資及陸資,27345,60390,21847,56940,5498,3450,89374,255370,31519,181941,57855,73429
2016/6/21,臺指選擇權,CALL,自營商,91110,186141,91574,208874,-464,-22733,95121,442263,70389,347592,24732,94671
2016/6/21,臺指選擇權,CALL,投信,0,0,0,0,0,0,1645,306,1660,306,-15,0
2016/6/21,臺指選擇權,CALL,外資及陸資,36609,113702,26788,93858,9821,19843,88503,458925,31245,214657,57258,244268
2016/6/21,臺指選擇權,PUT,自營商,106159,162877,110105,165897,-3946,-3020,110958,147252,121646,205896,-10688,-58644
2016/6/21,臺指選擇權,PUT,投信,0,0,0,0,0,0,0,0,0,0,0,0
2016/6/21,臺指選擇權,PUT,外資及陸資,26178,62137,22565,60592,3613,1545,95273,236102,33782,169196,61491,66906
2016/6/22,臺指選擇權,CALL,自營商,115740,226530,128062,219072,-12322,7458,57064,328410,54537,282176,2527,46234
2016/6/22,臺指選擇權,CALL,投信,0,0,0,0,0,0,1645,308,1660,309,-15,-1
2016/6/22,臺指選擇權,CALL,外資及陸資,42737,116189,35522,104337,7215,11853,91335,471058,30760,212323,60575,258735
2016/6/22,臺指選擇權,PUT,自營商,122610,190823,117663,200052,4947,-9230,87894,164771,73901,235303,13993,-70532
2016/6/22,臺指選擇權,PUT,投信,0,0,0,0,0,0,0,0,0,0,0,0
2016/6/22,臺指選擇權,PUT,外資及陸資,34184,85692,25286,81561,8898,4131,83620,264071,34091,187220,49529,76851
2016/6/23,臺指選擇權,CALL,自營商,62774,121688,72046,156063,-9272,-34375,73881,349088,80646,339285,-6765,9803
2016/6/23,臺指選擇權,CALL,投信,0,0,0,0,0,0,1645,320,1660,321,-15,-1
2016/6/23,臺指選擇權,CALL,外資及陸資,36180,94029,19630,70530,16550,23499,111823,519651,34679,229614,77144,290037
2016/6/23,臺指選擇權,PUT,自營商,68634,164189,71985,176836,-3351,-12646,114164,211323,103537,295259,10627,-83936
2016/6/23,臺指選擇權,PUT,投信,0,0,0,0,0,0,0,0,0,0,0,0
2016/6/23,臺指選擇權,PUT,外資及陸資,42949,101643,19302,70669,23647,30973,108761,313739,35562,203509,73199,110230
2016/6/24,臺指選擇權,CALL,自營商,240612,653794,260728,662199,-20116,-8405,88045,239890,114673,216352,-26628,23538
2016/6/24,臺指選擇權,CALL,投信,0,0,0,0,0,0,1645,338,1660,339,-15,-1
2016/6/24,臺指選擇權,CALL,外資及陸資,126297,383208,120452,360700,5845,22508,124384,314090,41305,163164,83079,150926
2016/6/24,臺指選擇權,PUT,自營商,279475,1094191,295155,1208171,-15680,-113980,123042,618260,128097,899479,-5055,-281219
2016/6/24,臺指選擇權,PUT,投信,0,0,0,0,0,0,0,0,0,0,0,0
2016/6/24,臺指選擇權,PUT,外資及陸資,172730,678884,152786,664065,19944,14819,133723,782750,40563,428204,93160,354546
2016/6/27,臺指選擇權,CALL,自營商,103150,233216,92797,215290,10353,17926,99777,298210,115638,248125,-15861,50085
2016/6/27,臺指選擇權,CALL,投信,0,0,0,0,0,0,1645,300,1660,301,-15,-1
2016/6/27,臺指選擇權,CALL,外資及陸資,37455,124498,35552,120297,1903,4201,131400,362968,46339,195885,85061,167083
2016/6/27,臺指選擇權,PUT,自營商,129837,289144,121702,296258,8135,-7114,142157,387573,139142,619400,3015,-231827
2016/6/27,臺指選擇權,PUT,投信,0,0,0,0,0,0,0,0,0,0,0,0
2016/6/27,臺指選擇權,PUT,外資及陸資,62061,170571,43030,135877,19031,34694,154358,542601,42173,334028,112185,208573
2016/6/28,臺指選擇權,CALL,自營商,101449,197212,101463,196734,-14,478,104795,337263,120887,286764,-16092,50499
2016/6/28,臺指選擇權,CALL,投信,0,0,0,0,0,0,1645,277,1660,278,-15,-1
2016/6/28,臺指選擇權,CALL,外資及陸資,33593,125194,36220,137174,-2627,-11980,128471,368276,46106,209757,82365,158519
2016/6/28,臺指選擇權,PUT,自營商,126006,220785,123757,181173,2249,39612,143976,302998,138679,450628,5297,-147630
2016/6/28,臺指選擇權,PUT,投信,0,0,0,0,0,0,0,0,0,0,0,0
2016/6/28,臺指選擇權,PUT,外資及陸資,36114,85838,45878,124564,-9764,-38726,149676,391665,47164,285654,102512,106011
2016/6/29,臺指選擇權,CALL,自營商,151420,339681,144150,277870,7270,61811,69976,310992,61085,218977,8891,92015
2016/6/29,臺指選擇權,CALL,投信,0,0,0,0,0,0,1645,260,1660,261,-15,-1
2016/6/29,臺指選擇權,CALL,外資及陸資,38222,143209,42999,163365,-4777,-20156,97023,364102,44499,225888,52524,138214
2016/6/29,臺指選擇權,PUT,自營商,158940,219145,184748,226658,-25808,-7513,84865,185451,95574,293379,-10709,-107928
2016/6/29,臺指選擇權,PUT,投信,0,0,0,0,0,0,0,0,0,0,0,0
2016/6/29,臺指選擇權,PUT,外資及陸資,27186,81334,30403,89685,-3217,-8351,116523,303165,47913,246543,68610,56622
2016/6/30,臺指選擇權,CALL,自營商,100119,245644,100060,290504,59,-44860,86507,395344,77273,329821,9234,65523
2016/6/30,臺指選擇權,CALL,投信,0,0,0,0,0,0,1645,270,1660,270,-15,0
2016/6/30,臺指選擇權,CALL,外資及陸資,37653,156543,36595,159663,1058,-3120,98804,432737,45126,274671,53678,158066
2016/6/30,臺指選擇權,PUT,自營商,133514,234512,141822,229674,-8308,4838,96787,163833,116043,228919,-19256,-65086
2016/6/30,臺指選擇權,PUT,投信,0,0,0,0,0,0,0,0,0,0,0,0
2016/6/30,臺指選擇權,PUT,外資及陸資,54643,119550,40167,114468,14476,5082,133211,258592,50175,204150,83036,54442
2016/7/1,臺指選擇權,CALL,自營商,99647,242413,102703,249280,-3056,-6867,86302,507473,80043,439695,6259,67778
2016/7/1,臺指選擇權,CALL,投信,0,0,0,0,0,0,1645,289,1660,289,-15,0
2016/7/1,臺指選擇權,CALL,外資及陸資,37739,150573,34616,139405,3123,11168,104000,553556,47265,348187,56735,205369
2016/7/1,臺指選擇權,PUT,自營商,126530,190155,149525,192882,-22995,-2726,91269,125807,133529,164767,-42260,-38960
2016/7/1,臺指選擇權,PUT,投信,0,0,0,0,0,0,0,0,0,0,0,0
2016/7/1,臺指選擇權,PUT,外資及陸資,35500,80201,31510,78623,3990,1578,138564,203683,51517,155907,87047,47776
2016/7/4,臺指選擇權,CALL,自營商,93220,205446,99859,226481,-6639,-21035,84820,489979,85177,448250,-357,41729
2016/7/4,臺指選擇權,CALL,投信,0,0,0,0,0,0,1645,281,1660,281,-15,0
2016/7/4,臺指選擇權,CALL,外資及陸資,34429,121135,35950,129227,-1521,-8092,104459,551145,49233,354910,55226,196235
2016/7/4,臺指選擇權,PUT,自營商,124366,163274,123869,156575,497,6698,98428,133533,140210,152741,-41782,-19208
2016/7/4,臺指選擇權,PUT,投信,0,0,0,0,0,0,0,0,0,0,0,0
2016/7/4,臺指選擇權,PUT,外資及陸資,38507,72104,34697,73579,3810,-1475,147887,195570,57058,154670,90829,40900
2016/7/5,臺指選擇權,CALL,自營商,81563,147063,79258,144013,2305,3050,90592,440690,88624,394952,1968,45738
2016/7/5,臺指選擇權,CALL,投信,0,0,0,0,0,0,1645,251,1660,251,-15,0
2016/7/5,臺指選擇權,CALL,外資及陸資,26249,76798,30212,89775,-3963,-12977,103573,504689,52294,335264,51279,169425
2016/7/5,臺指選擇權,PUT,自營商,91979,117438,88001,120876,3978,-3438,104226,140404,142013,163867,-37787,-23463
2016/7/5,臺指選擇權,PUT,投信,0,0,0,0,0,0,0,0,0,0,0,0
2016/7/5,臺指選擇權,PUT,外資及陸資,28127,62694,25374,64712,2753,-2019,149931,199922,56370,161383,93561,38539
2016/7/6,臺指選擇權,CALL,自營商,167089,233268,198203,302352,-31114,-69084,64445,252312,85120,246848,-20675,5464
2016/7/6,臺指選擇權,CALL,投信,45,146,45,146,0,0,1645,172,1660,172,-15,0
2016/7/6,臺指選擇權,CALL,外資及陸資,50277,118606,54030,128142,-3753,-9536,102685,348535,55263,231166,47422,117369
2016/7/6,臺指選擇權,PUT,自營商,197229,394820,187002,365717,10227,29103,82378,233737,103793,234976,-21415,-1239
2016/7/6,臺指選擇權,PUT,投信,0,0,0,0,0,0,0,0,0,0,0,0
2016/7/6,臺指選擇權,PUT,外資及陸資,76030,215210,64555,203550,11475,11660,146462,323210,58741,253494,87721,69716
2016/7/7,臺指選擇權,CALL,自營商,71330,156629,61330,130761,10000,25868,73521,329283,84282,300069,-10761,29214
2016/7/7,臺指選擇權,CALL,投信,0,0,0,0,0,0,1645,207,1660,208,-15,-1
2016/7/7,臺指選擇權,CALL,外資及陸資,23787,80524,22795,78284,992,2240,103768,419582,55315,285728,48453,133854
2016/7/7,臺指選擇權,PUT,自營商,83597,113529,94506,143885,-10909,-30357,88337,155127,120956,183723,-32619,-28596
2016/7/7,臺指選擇權,PUT,投信,0,0,0,0,0,0,0,0,0,0,0,0
2016/7/7,臺指選擇權,PUT,外資及陸資,33375,69274,25004,67608,8371,1666,156993,242337,60946,192407,96047,49930
2016/7/11,臺指選擇權,CALL,自營商,121580,381191,122249,317233,-669,63957,81343,579008,92757,476604,-11414,102404
2016/7/11,臺指選擇權,CALL,投信,0,0,0,0,0,0,1645,284,1660,285,-15,-1
2016/7/11,臺指選擇權,CALL,外資及陸資,40629,165452,40799,167507,-170,-2055,103355,641808,55077,453137,48278,188671
2016/7/11,臺指選擇權,PUT,自營商,145678,182952,163863,181211,-18185,1741,100960,112239,151772,120830,-50812,-8591
2016/7/11,臺指選擇權,PUT,投信,0,0,0,0,0,0,0,0,0,0,0,0
2016/7/11,臺指選擇權,PUT,外資及陸資,33411,65554,28395,58685,5016,6868,162768,149471,61698,114367,101070,35104
2016/7/12,臺指選擇權,CALL,自營商,91986,199258,79207,183050,12779,16208,87782,646174,86313,514981,1469,131193
2016/7/12,臺指選擇權,CALL,投信,0,0,0,0,0,0,1645,304,1660,304,-15,0
2016/7/12,臺指選擇權,CALL,外資及陸資,38636,129228,33498,121438,5138,7790,110744,716413,57283,506043,53461,210370
2016/7/12,臺指選擇權,PUT,自營商,99991,117926,113190,122142,-13199,-4216,102011,100908,166025,109910,-64014,-9002
2016/7/12,臺指選擇權,PUT,投信,0,0,0,0,0,0,0,0,0,0,0,0
2016/7/12,臺指選擇權,PUT,外資及陸資,24789,55118,26409,60741,-1620,-5622,165516,140641,66097,113977,99419,26664
2016/7/13,臺指選擇權,CALL,自營商,155561,287559,164545,305361,-8984,-17802,74824,591209,82006,471250,-7182,119959
2016/7/13,臺指選擇權,CALL,投信,0,0,0,0,0,0,1645,321,1660,321,-15,0
2016/7/13,臺指選擇權,CALL,外資及陸資,52881,145034,59646,166604,-6765,-21570,111230,733193,65817,542805,45413,190388
2016/7/13,臺指選擇權,PUT,自營商,183874,228075,189420,213450,-5546,14625,84811,116756,135346,117941,-50535,-1185
2016/7/13,臺指選擇權,PUT,投信,0,0,0,0,0,0,0,0,0,0,0,0
2016/7/13,臺指選擇權,PUT,外資及陸資,52803,106738,49300,113315,3503,-6576,166468,145760,69018,123366,97450,22394
2016/7/14,臺指選擇權,CALL,自營商,80660,167385,75663,169092,4997,-1708,85527,625812,87725,505045,-2198,120767
2016/7/14,臺指選擇權,CALL,投信,0,0,0,0,0,0,1645,357,1660,357,-15,0
2016/7/14,臺指選擇權,CALL,外資及陸資,33210,109546,32948,108816,262,730,107794,760340,62038,563607,45756,196733
2016/7/14,臺指選擇權,PUT,自營商,89949,135432,89086,131965,863,3467,93938,121145,143678,119253,-49740,1892
2016/7/14,臺指選擇權,PUT,投信,0,0,0,0,0,0,0,0,0,0,0,0
2016/7/14,臺指選擇權,PUT,外資及陸資,28992,63034,25786,69183,3206,-6149,174095,141532,73470,124325,100625,17207
2016/7/15,臺指選擇權,CALL,自營商,119172,342269,108629,281034,10543,61235,91858,834258,83496,633422,8362,200836
2016/7/15,臺指選擇權,CALL,投信,200,2494,200,3082,0,-588,1645,502,1660,502,-15,0
2016/7/15,臺指選擇權,CALL,外資及陸資,55263,217122,57550,212124,-2287,4998,105432,974056,61974,718881,43458,255175
2016/7/15,臺指選擇權,PUT,自營商,121390,166390,136419,156576,-15029,9814,94716,100029,159318,93400,-64602,6629
2016/7/15,臺指選擇權,PUT,投信,0,0,0,0,0,0,0,0,0,0,0,0
2016/7/15,臺指選擇權,PUT,外資及陸資,43579,93098,39055,94425,4524,-1328,181359,118827,76164,99900,105195,18927
2016/7/18,臺指選擇權,CALL,自營商,101888,223005,111027,293937,-9139,-70932,91353,1013662,92073,839459,-720,174203
2016/7/18,臺指選擇權,CALL,投信,0,0,0,0,0,0,1645,819,1660,820,-15,-1
2016/7/18,臺指選擇權,CALL,外資及陸資,44769,153704,51120,185032,-6351,-31329,105046,1201100,67925,912381,37121,288719
2016/7/18,臺指選擇權,PUT,自營商,118459,129204,123855,137610,-5396,-8406,103186,78673,173202,84023,-70016,-5350
2016/7/18,臺指選擇權,PUT,投信,0,0,0,0,0,0,0,0,0,0,0,0
2016/7/18,臺指選擇權,PUT,外資及陸資,32762,62688,30593,56546,2169,6142,186403,101790,79022,77892,107381,23898
2016/7/19,臺指選擇權,CALL,自營商,114850,223965,129244,287766,-14394,-63801,96110,1079106,111104,981660,-14994,97446
2016/7/19,臺指選擇權,CALL,投信,0,0,0,0,0,0,1645,999,1660,1000,-15,-1
2016/7/19,臺指選擇權,CALL,外資及陸資,52760,165962,50209,173494,2551,-7532,111520,1325112,71801,1017694,39719,307418
2016/7/19,臺指選擇權,PUT,自營商,142806,167995,146654,157290,-3848,10705,114398,77100,188236,83391,-73838,-6291
2016/7/19,臺指選擇權,PUT,投信,0,0,0,0,0,0,0,0,0,0,0,0
2016/7/19,臺指選擇權,PUT,外資及陸資,47033,86217,39417,89299,7616,-3082,194409,105895,79467,84603,114942,21292
2016/7/20,臺指選擇權,CALL,自營商,185086,442180,200472,456877,-15386,-14697,48279,361012,56659,351830,-8380,9182
2016/7/20,臺指選擇權,CALL,投信,0,0,0,0,0,0,1645,944,1660,945,-15,-1
2016/7/20,臺指選擇權,CALL,外資及陸資,50490,126547,46762,138682,3728,-12135,72267,723894,49824,462465,22443,261429
2016/7/20,臺指選擇權,PUT,自營商,175720,284112,183373,289657,-7653,-5545,40609,84599,53012,113544,-12403,-28945
2016/7/20,臺指選擇權,PUT,投信,0,0,0,0,0,0,0,0,0,0,0,0
2016/7/20,臺指選擇權,PUT,外資及陸資,45975,97971,48423,113913,-2448,-15941,56685,119797,41280,108971,15405,10826
2016/7/21,臺指選擇權,CALL,自營商,128504,298726,128858,349389,-354,-50664,73492,472474,82223,513710,-8731,-41236
2016/7/21,臺指選擇權,CALL,投信,0,0,0,0,0,0,1645,1378,1660,1380,-15,-2
2016/7/21,臺指選擇權,CALL,外資及陸資,42992,154263,47286,187393,-4294,-33130,79658,900815,61492,631712,18166,269103
2016/7/21,臺指選擇權,PUT,自營商,130475,239000,117768,256837,12707,-17837,78400,125489,78140,156803,260,-31314
2016/7/21,臺指選擇權,PUT,投信,0,0,0,0,0,0,0,0,0,0,0,0
2016/7/21,臺指選擇權,PUT,外資及陸資,43101,110218,40008,117974,3093,-7756,66603,116773,48062,110130,18541,6643
2016/7/22,臺指選擇權,CALL,自營商,99346,190806,106541,203248,-7195,-12443,83088,426308,99083,454303,-15995,-27995
2016/7/22,臺指選擇權,CALL,投信,0,0,0,0,0,0,1645,1111,1660,1112,-15,-1
2016/7/22,臺指選擇權,CALL,外資及陸資,29136,81005,30277,99524,-1141,-18519,83429,815554,66374,573129,17055,242425
2016/7/22,臺指選擇權,PUT,自營商,107109,214849,96543,193538,10566,21311,98489,186680,87794,205363,10695,-18683
2016/7/22,臺指選擇權,PUT,投信,353,1071,0,0,353,1071,0,0,0,0,0,0
2016/7/22,臺指選擇權,PUT,外資及陸資,33802,91434,32731,97420,1071,-5986,72328,145635,52779,150774,19549,-5139
2016/7/25,臺指選擇權,CALL,自營商,194985,345895,208201,340374,-13216,5521,91963,407496,121103,425633,-29140,-18137
2016/7/25,臺指選擇權,CALL,投信,0,0,0,0,0,0,1645,837,1660,837,-15,0
2016/7/25,臺指選擇權,CALL,外資及陸資,61648,160777,60341,171705,1307,-10928,85588,745756,67157,521232,18431,224524
2016/7/25,臺指選擇權,PUT,自營商,191466,444961,170189,384267,21277,60694,118086,240297,86162,194027,31924,46270
2016/7/25,臺指選擇權,PUT,投信,0,0,0,0,0,0,0,0,0,0,0,0
2016/7/25,臺指選擇權,PUT,外資及陸資,74862,239787,63486,222955,11376,16833,82599,168072,51708,162050,30891,6022
2016/7/26,臺指選擇權,CALL,自營商,130793,226244,118504,221116,12289,5128,105156,513177,121840,536791,-16684,-23614
2016/7/26,臺指選擇權,CALL,投信,0,0,0,0,0,0,1645,995,1660,996,-15,-1
2016/7/26,臺指選擇權,CALL,外資及陸資,41369,125521,40917,135723,452,-10202,85766,838794,66858,612926,18908,225868
2016/7/26,臺指選擇權,PUT,自營商,124039,182575,135043,222075,-11004,-39501,119014,164593,98201,150922,20813,13671
2016/7/26,臺指選擇權,PUT,投信,0,0,0,0,0,0,0,0,0,0,0,0
2016/7/26,臺指選擇權,PUT,外資及陸資,39797,90081,39436,100720,361,-10640,84756,129503,53521,129403,31235,100
2016/7/27,臺指選擇權,CALL,自營商,199039,392212,213976,407212,-14937,-15000,76601,507639,100343,510787,-23742,-3148
2016/7/27,臺指選擇權,CALL,投信,0,0,0,0,0,0,1645,1082,1660,1082,-15,0
2016/7/27,臺指選擇權,CALL,外資及陸資,57430,177652,58612,197128,-1182,-19476,80124,868323,70520,653526,9604,214797
2016/7/27,臺指選擇權,PUT,自營商,200380,340110,216057,330726,-15677,9383,89039,179870,80542,169167,8497,10703
2016/7/27,臺指選擇權,PUT,投信,0,0,0,0,0,0,0,0,0,0,0,0
2016/7/27,臺指選擇權,PUT,外資及陸資,56066,122047,52288,124975,3778,-2928,85410,144778,56104,147145,29306,-2367
2016/7/28,臺指選擇權,CALL,自營商,127994,248619,109731,255954,18263,-7336,108259,530338,113764,539494,-5505,-9156
2016/7/28,臺指選擇權,CALL,投信,0,0,0,0,0,0,1645,1085,1660,1086,-15,-1
2016/7/28,臺指選擇權,CALL,外資及陸資,36077,115799,35580,121703,497,-5904,83657,873955,73531,662865,10126,211090
2016/7/28,臺指選擇權,PUT,自營商,104187,241809,101011,285858,3176,-44049,111596,202934,100060,237534,11536,-34600
2016/7/28,臺指選擇權,PUT,投信,0,0,0,0,0,0,0,0,0,0,0,0
2016/7/28,臺指選擇權,PUT,外資及陸資,44056,112196,37719,127522,6337,-15326,97293,156224,61636,172593,35657,-16369
2016/7/29,臺指選擇權,CALL,自營商,125025,212123,132374,225050,-7349,-12927,113382,419969,126324,403434,-12942,16535
2016/7/29,臺指選擇權,CALL,投信,0,0,0,0,0,0,1645,729,1660,729,-15,0
2016/7/29,臺指選擇權,CALL,外資及陸資,40273,107699,40590,118589,-317,-10890,87711,733587,77915,533289,9796,200298
2016/7/29,臺指選擇權,PUT,自營商,118964,268478,101071,230968,17893,37511,139169,321211,109735,331760,29434,-10549
2016/7/29,臺指選擇權,PUT,投信,0,0,0,0,0,0,0,0,0,0,0,0
2016/7/29,臺指選擇權,PUT,外資及陸資,48459,147273,42626,141016,5833,6258,105893,206634,64368,222967,41525,-16333
2016/8/1,臺指選擇權,CALL,自營商,109066,229021,92269,226627,16797,2394,126048,621326,122136,622791,3912,-1465
2016/8/1,臺指選擇權,CALL,投信,0,0,0,0,0,0,1645,1141,1660,1141,-15,0
2016/8/1,臺指選擇權,CALL,外資及陸資,33419,112546,33072,118654,347,-6108,88487,944243,78303,741027,10184,203216
2016/8/1,臺指選擇權,PUT,自營商,118058,190760,122802,218762,-4744,-28002,140340,167600,115499,180440,24841,-12840
2016/8/1,臺指選擇權,PUT,投信,0,0,0,0,0,0,0,0,0,0,0,0
2016/8/1,臺指選擇權,PUT,外資及陸資,37502,85987,34126,91300,3376,-5313,111184,131583,66314,133694,44870,-2111
2016/8/2,臺指選擇權,CALL,自營商,75881,116471,81330,144168,-5449,-27697,127535,553347,129155,564055,-1620,-10708
2016/8/2,臺指選擇權,CALL,投信,0,0,0,0,0,0,1645,1032,1660,1032,-15,0
2016/8/2,臺指選擇權,CALL,外資及陸資,23878,67129,25257,79341,-1379,-12212,87843,881043,79014,685095,8829,195948
2016/8/2,臺指選擇權,PUT,自營商,84067,121835,75336,102765,8731,19070,150719,192886,117105,187968,33614,4918
2016/8/2,臺指選擇權,PUT,投信,0,0,0,0,0,0,0,0,0,0,0,0
2016/8/2,臺指選擇權,PUT,外資及陸資,25692,56581,23192,59537,2500,-2956,116593,139864,69200,150830,47393,-10966
2016/8/3,臺指選擇權,CALL,自營商,173663,281045,178464,287198,-4801,-6153,90737,447422,111962,446990,-21225,432
2016/8/3,臺指選擇權,CALL,投信,0,0,0,0,0,0,1645,675,1660,675,-15,0
2016/8/3,臺指選擇權,CALL,外資及陸資,51974,132286,46268,124730,5706,7556,82504,750849,77792,552422,4712,198427
2016/8/3,臺指選擇權,PUT,自營商,161265,369370,172196,342282,-10931,27088,101086,219293,96133,213276,4953,6017
2016/8/3,臺指選擇權,PUT,投信,0,0,0,0,0,0,0,0,0,0,0,0
2016/8/3,臺指選擇權,PUT,外資及陸資,58334,168835,47830,138834,10504,30002,108835,183013,67110,185090,41725,-2077
2016/8/4,臺指選擇權,CALL,自營商,108301,183096,102622,213929,5679,-30833,115083,493738,130676,526149,-15593,-32411
2016/8/4,臺指選擇權,CALL,投信,250,52,250,52,0,0,1895,834,1910,834,-15,0
2016/8/4,臺指選擇權,CALL,外資及陸資,33817,107445,32839,115147,978,-7701,84455,794280,78736,593405,5719,200875
2016/8/4,臺指選擇權,PUT,自營商,109964,181609,84997,162006,24967,19603,138601,204232,108785,186516,29816,17716
2016/8/4,臺指選擇權,PUT,投信,0,0,0,0,0,0,0,0,0,0,0,0
2016/8/4,臺指選擇權,PUT,外資及陸資,33314,92672,28114,96770,5200,-4098,115073,155435,68143,158535,46930,-3100
2016/8/5,臺指選擇權,CALL,自營商,124326,292781,112521,252613,11805,40168,123551,645107,127214,652122,-3663,-7015
2016/8/5,臺指選擇權,CALL,投信,0,0,0,0,0,0,1895,1218,1910,1218,-15,0
2016/8/5,臺指選擇權,CALL,外資及陸資,42477,145305,39759,147883,2718,-2578,86911,934952,78420,727326,8491,207626
2016/8/5,臺指選擇權,PUT,自營商,115639,182649,131194,197646,-15555,-14997,134724,143877,120529,138753,14195,5124
2016/8/5,臺指選擇權,PUT,投信,400,2590,0,0,400,2590,400,2260,0,0,400,2260
2016/8/5,臺指選擇權,PUT,外資及陸資,39968,95149,33829,85634,6139,9514,119928,125623,66870,109664,53058,15959
2016/8/8,臺指選擇權,CALL,自營商,107453,211507,115553,248181,-8100,-36674,127054,711035,138813,759555,-11759,-48520
2016/8/8,臺指選擇權,CALL,投信,0,0,0,0,0,0,1895,1314,1910,1314,-15,0
2016/8/8,臺指選擇權,CALL,外資及陸資,39652,121558,38695,128970,957,-7411,87404,1006645,78020,798569,9384,208076
2016/8/8,臺指選擇權,PUT,自營商,132789,218104,125639,166745,7150,51359,147761,142897,126305,95599,21456,47298
2016/8/8,臺指選擇權,PUT,投信,0,0,0,0,0,0,400,1500,0,0,400,1500
2016/8/8,臺指選擇權,PUT,外資及陸資,45610,97918,35757,87002,9853,10916,126516,106505,63542,82993,62974,23512
2016/8/9,臺指選擇權,CALL,自營商,97054,176885,90517,176330,6537,555,137531,689703,142751,721969,-5220,-32266
2016/8/9,臺指選擇權,CALL,投信,0,0,0,0,0,0,1895,1082,1910,1082,-15,0
2016/8/9,臺指選擇權,CALL,外資及陸資,28616,87018,27657,92235,959,-5217,87858,986433,77504,777752,10354,208681
2016/8/9,臺指選擇權,PUT,自營商,95923,117459,106002,127709,-10079,-10250,151690,145864,140355,114324,11335,31540
2016/8/9,臺指選擇權,PUT,投信,0,0,0,0,0,0,400,1300,0,0,400,1300
2016/8/9,臺指選擇權,PUT,外資及陸資,32104,62305,27621,61912,4483,393,130726,104205,63284,81240,67442,22965
2016/8/10,臺指選擇權,CALL,自營商,146278,286714,148835,293362,-2557,-6648,94088,664702,118613,715646,-24525,-50944
2016/8/10,臺指選擇權,CALL,投信,100,1,100,1,0,0,1995,1226,2010,1226,-15,0
2016/8/10,臺指選擇權,CALL,外資及陸資,44652,155497,41150,136816,3502,18681,83772,1059799,73690,828750,10082,231049
2016/8/10,臺指選擇權,PUT,自營商,144324,196460,149341,157740,-5017,38721,122773,137304,106603,75604,16170,61700
2016/8/10,臺指選擇權,PUT,投信,0,0,0,0,0,0,400,890,0,0,400,890
2016/8/10,臺指選擇權,PUT,外資及陸資,40488,74437,30654,69918,9834,4519,134130,93002,63627,69694,70503,23308
2016/8/11,臺指選擇權,CALL,自營商,135750,204278,157437,297221,-21687,-92943,106062,553498,152290,655993,-46228,-102495
2016/8/11,臺指選擇權,CALL,投信,200,450,0,0,200,450,2195,1418,2010,858,185,560
2016/8/11,臺指選擇權,CALL,外資及陸資,49740,142676,55899,172224,-6159,-29548,84226,934505,80268,724696,3958,209809
2016/8/11,臺指選擇權,PUT,自營商,145354,261403,126230,219306,19124,42097,150920,226509,115702,96360,35218,130149
2016/8/11,臺指選擇權,PUT,投信,0,0,400,894,-400,-894,0,0,0,0,0,0
2016/8/11,臺指選擇權,PUT,外資及陸資,69221,162670,51921,164697,17300,-2027,154928,128460,67160,100255,87768,28205
2016/8/12,臺指選擇權,CALL,自營商,94198,201091,66473,138110,27725,62981,120912,622873,139389,686394,-18477,-63521
2016/8/12,臺指選擇權,CALL,投信,0,0,0,0,0,0,2195,1538,2010,859,185,679
2016/8/12,臺指選擇權,CALL,外資及陸資,35855,123802,29918,106360,5937,17442,87908,1013440,78005,789399,9903,224041
2016/8/12,臺指選擇權,PUT,自營商,82228,119303,92805,134651,-10577,-15347,152508,159830,127788,91442,24720,68388
2016/8/12,臺指選擇權,PUT,投信,0,0,0,0,0,0,0,0,0,0,0,0
2016/8/12,臺指選擇權,PUT,外資及陸資,28686,67056,25239,67621,3447,-564,160158,106438,68898,90506,91260,15932
2016/8/15,臺指選擇權,CALL,自營商,80570,140457,83524,163911,-2954,-23454,124184,598151,145606,669793,-21422,-71642
2016/8/15,臺指選擇權,CALL,投信,0,0,0,0,0,0,2195,1408,2010,838,185,570
2016/8/15,臺指選擇權,CALL,外資及陸資,30474,88134,31674,90594,-1200,-2459,87543,1008673,78866,776559,8677,232114
2016/8/15,臺指選擇權,PUT,自營商,83928,122455,73885,107559,10043,14897,165826,164396,131058,94172,34768,70224
2016/8/15,臺指選擇權,PUT,投信,0,0,0,0,0,0,0,0,0,0,0,0
2016/8/15,臺指選擇權,PUT,外資及陸資,30263,61909,26880,67654,3383,-5746,166376,99740,71702,92158,94674,7582
2016/8/16,臺指選擇權,CALL,自營商,144922,199781,145171,203997,-249,-4216,122887,513788,144530,534245,-21643,-20457
2016/8/16,臺指選擇權,CALL,投信,0,0,0,0,0,0,2195,776,2010,562,185,214
2016/8/16,臺指選擇權,CALL,外資及陸資,57520,336958,53418,348818,4102,-11860,89876,898598,77096,671310,12780,227288
2016/8/16,臺指選擇權,PUT,自營商,124609,189697,117143,192969,7466,-3272,171242,197175,129002,118966,42240,78209
2016/8/16,臺指選擇權,PUT,投信,0,0,0,0,0,0,0,0,0,0,0,0
2016/8/16,臺指選擇權,PUT,外資及陸資,47847,123294,47788,132373,59,-9079,168814,121444,74084,125087,94730,-3643
2016/8/17,臺指選擇權,CALL,自營商,169555,313820,173801,281190,-4246,32630,60936,324345,46918,312437,14018,11908
2016/8/17,臺指選擇權,CALL,投信,700,1846,700,1845,0,2,2350,2417,2350,2417,0,0
2016/8/17,臺指選擇權,CALL,外資及陸資,38454,88564,34425,96491,4029,-7928,64882,693378,43692,459826,21190,233552
2016/8/17,臺指選擇權,PUT,自營商,117686,179719,134069,186011,-16383,-6291,51830,107313,44291,94008,7539,13305
2016/8/17,臺指選擇權,PUT,投信,0,0,0,0,0,0,0,0,0,0,0,0
2016/8/17,臺指選擇權,PUT,外資及陸資,31314,69084,27212,73578,4102,-4494,80238,114297,45276,131342,34962,-17045
2016/8/18,臺指選擇權,CALL,自營商,81232,325258,72271,359110,8961,-33853,83032,513159,60157,540485,22875,-27326
2016/8/18,臺指選擇權,CALL,投信,0,0,0,0,0,0,2350,2393,2350,2393,0,0
2016/8/18,臺指選擇權,CALL,外資及陸資,29763,118885,26652,100010,3111,18875,68631,748620,44338,487395,24293,261225
2016/8/18,臺指選擇權,PUT,自營商,92922,182625,75451,167703,17471,14923,82523,159148,57545,134331,24978,24817
2016/8/18,臺指選擇權,PUT,投信,0,0,0,0,0,0,0,0,0,0,0,0
2016/8/18,臺指選擇權,PUT,外資及陸資,37057,84623,28473,94039,8584,-9416,94298,116421,50709,138391,43589,-21970
2016/8/19,臺指選擇權,CALL,自營商,151791,313546,162415,321903,-10624,-8357,88253,460689,76002,465660,12251,-4971
2016/8/19,臺指選擇權,CALL,投信,0,0,0,0,0,0,2350,1684,2350,1684,0,0
2016/8/19,臺指選擇權,CALL,外資及陸資,49004,160120,50118,165703,-1114,-5584,69006,634797,45813,408845,23193,225952
2016/8/19,臺指選擇權,PUT,自營商,153197,322097,148783,283476,4414,38622,99418,294357,70062,201072,29356,93285
2016/8/19,臺指選擇權,PUT,投信,0,0,0,0,0,0,0,0,0,0,0,0
2016/8/19,臺指選擇權,PUT,外資及陸資,54402,149635,48896,157348,5506,-7713,102454,157878,53343,196561,49111,-38683
2016/8/22,臺指選擇權,CALL,自營商,147820,263382,164100,222203,-16280,41180,97360,461927,101427,424779,-4067,37148
2016/8/22,臺指選擇權,CALL,投信,0,0,0,0,0,0,2350,1337,2350,1337,0,0
2016/8/22,臺指選擇權,CALL,外資及陸資,42397,108232,42879,116927,-482,-8696,72523,570744,49753,369813,22770,200931
2016/8/22,臺指選擇權,PUT,自營商,136532,333259,139063,304994,-2531,28265,110805,386001,83985,249039,26820,136962
2016/8/22,臺指選擇權,PUT,投信,0,0,0,0,0,0,0,0,0,0,0,0
2016/8/22,臺指選擇權,PUT,外資及陸資,59208,187978,53170,195663,6038,-7686,110674,180465,55569,233408,55105,-52943
2016/8/23,臺指選擇權,CALL,自營商,121967,170472,103887,178851,18080,-8379,103746,563731,89749,501428,13997,62303
2016/8/23,臺指選擇權,CALL,投信,0,0,0,0,0,0,2350,1653,2350,1653,0,0
2016/8/23,臺指選擇權,CALL,外資及陸資,37484,100927,32514,97262,4970,3665,76284,672094,48538,441339,27746,230755
2016/8/23,臺指選擇權,PUT,自營商,106551,133017,127609,184809,-21058,-51792,99523,239084,93884,192732,5639,46352
2016/8/23,臺指選擇權,PUT,投信,0,0,0,0,0,0,0,0,0,0,0,0
2016/8/23,臺指選擇權,PUT,外資及陸資,30120,75599,31307,86424,-1187,-10825,110682,131186,56778,181104,53904,-49918
2016/8/24,臺指選擇權,CALL,自營商,114608,163461,135710,205392,-21102,-41931,73374,497685,61663,464350,11711,33335
2016/8/24,臺指選擇權,CALL,投信,0,0,0,0,0,0,2350,1596,2350,1596,0,0
2016/8/24,臺指選擇權,CALL,外資及陸資,30089,71513,27992,74818,2097,-3305,75673,637275,46691,418482,28982,218793
2016/8/24,臺指選擇權,PUT,自營商,125718,218249,125355,181865,363,36384,79829,252443,73440,189928,6389,62515
2016/8/24,臺指選擇權,PUT,投信,0,0,0,0,0,0,0,0,0,0,0,0
2016/8/24,臺指選擇權,PUT,外資及陸資,34366,80349,31577,79543,2789,806,103397,146241,57053,197997,46344,-51756
2016/8/25,臺指選擇權,CALL,自營商,122210,268311,105935,241868,16275,26443,92279,660133,64281,564933,27998,95200
2016/8/25,臺指選擇權,CALL,投信,0,0,0,0,0,0,2350,2220,2350,2220,0,0
2016/8/25,臺指選擇權,CALL,外資及陸資,46163,142155,31783,119245,14380,22909,91641,809616,48230,529651,43411,279965
2016/8/25,臺指選擇權,PUT,自營商,132760,200608,144607,230550,-11847,-29942,82187,183903,87665,155475,-5478,28428
2016/8/25,臺指選擇權,PUT,投信,0,0,0,0,0,0,0,0,0,0,0,0
2016/8/25,臺指選擇權,PUT,外資及陸資,47043,95890,34394,95906,12649,-15,118685,116138,59726,144691,58959,-28553
2016/8/26,臺指選擇權,CALL,自營商,85102,158212,96324,204375,-11222,-46163,97762,669244,81075,619573,16687,49671
2016/8/26,臺指選擇權,CALL,投信,0,0,0,0,0,0,2350,2354,2350,2354,0,0
2016/8/26,臺指選擇權,CALL,外資及陸資,25915,92267,30408,100493,-4493,-8226,90717,827731,51806,549817,38911,277914
2016/8/26,臺指選擇權,PUT,自營商,99734,147169,100908,156533,-1174,-9364,96073,195140,102815,173699,-6742,21441
2016/8/26,臺指選擇權,PUT,投信,48,85,0,0,48,85,48,83,0,0,48,83
2016/8/26,臺指選擇權,PUT,外資及陸資,26269,70570,25079,64801,1190,5769,120902,121229,60693,142841,60209,-21612
2016/8/29,臺指選擇權,CALL,自營商,143614,296899,149591,303712,-5977,-6813,106564,656000,95710,618474,10854,37526
2016/8/29,臺指選擇權,CALL,投信,0,0,0,0,0,0,2350,2046,2350,2046,0,0
2016/8/29,臺指選擇權,CALL,外資及陸資,47320,130836,46584,141929,736,-11094,93339,759429,53728,508639,39611,250790
2016/8/29,臺指選擇權,PUT,自營商,156641,321698,136333,246776,20308,74922,113324,251385,99782,174194,13542,77191
2016/8/29,臺指選擇權,PUT,投信,8,22,56,111,-48,-89,0,0,0,0,0,0
2016/8/29,臺指選擇權,PUT,外資及陸資,57879,156749,47356,144366,10523,12383,131344,137688,60595,154964,70749,-17276
2016/8/30,臺指選擇權,CALL,自營商,110932,196207,101686,191799,9246,4408,114454,646520,94389,594516,20065,52004
2016/8/30,臺指選擇權,CALL,投信,0,0,0,0,0,0,2350,1962,2350,1962,0,0
2016/8/30,臺指選擇權,CALL,外資及陸資,32684,93215,33043,97615,-359,-4400,95858,751946,56554,509260,39304,242686
2016/8/30,臺指選擇權,PUT,自營商,107319,174090,120087,185468,-12768,-11378,110583,264058,109843,207150,740,56908
2016/8/30,臺指選擇權,PUT,投信,56,105,0,0,56,105,56,106,0,0,56,106
2016/8/30,臺指選擇權,PUT,外資及陸資,32866,88543,31911,81712,955,6831,132492,141186,60881,154947,71611,-13761
2016/8/31,臺指選擇權,CALL,自營商,177061,275341,193548,322421,-16487,-47080,74650,550448,77736,543195,-3086,7253
2016/8/31,臺指選擇權,CALL,投信,0,0,0,0,0,0,2350,1596,2350,1596,0,0
2016/8/31,臺指選擇權,CALL,外資及陸資,40772,103247,41643,122281,-871,-19034,92566,663527,56783,457190,35783,206337
2016/8/31,臺指選擇權,PUT,自營商,181978,316819,187578,298801,-5600,18018,85339,291332,84027,245407,1312,45925
2016/8/31,臺指選擇權,PUT,投信,0,0,56,104,-56,-104,9,23,9,23,0,0
2016/8/31,臺指選擇權,PUT,外資及陸資,42268,100894,41294,102758,974,-1864,121251,174200,62074,197358,59177,-23158
2016/9/1,臺指選擇權,CALL,自營商,123434,190123,122106,218701,1328,-28578,89368,503699,91187,519464,-1819,-15765
2016/9/1,臺指選擇權,CALL,投信,0,0,0,0,0,0,2350,1394,2350,1394,0,0
2016/9/1,臺指選擇權,CALL,外資及陸資,37922,104803,36168,105045,1754,-242,95601,617860,58040,420870,37561,196990
2016/9/1,臺指選擇權,PUT,自營商,135212,257667,114252,235096,20960,22570,114886,338124,92566,269472,22320,68652
2016/9/1,臺指選擇權,PUT,投信,0,0,0,0,0,0,9,26,9,26,0,0
2016/9/1,臺指選擇權,PUT,外資及陸資,51338,130389,35810,125584,15528,4805,137826,196104,63096,219918,74730,-23814
2016/9/2,臺指選擇權,CALL,自營商,83671,136521,81685,128008,1986,8514,92934,495119,92732,501199,202,-6080
2016/9/2,臺指選擇權,CALL,投信,0,0,0,0,0,0,2350,1327,2350,1327,0,0
2016/9/2,臺指選擇權,CALL,外資及陸資,26829,77519,26224,77621,605,-102,97455,606717,59281,410460,38174,196257
2016/9/2,臺指選擇權,PUT,自營商,88188,140758,83525,155216,4663,-14457,127088,347234,100148,294618,26940,52616
2016/9/2,臺指選擇權,PUT,投信,0,0,0,0,0,0,9,27,9,27,0,0
2016/9/2,臺指選擇權,PUT,外資及陸資,28608,82437,26401,83478,2207,-1042,140600,201642,63693,227248,76907,-25606
2016/9/5,臺指選擇權,CALL,自營商,107381,220378,83139,159410,24242,60968,105782,665604,81053,611791,24729,53813
2016/9/5,臺指選擇權,CALL,投信,0,0,0,0,0,0,2350,1816,2350,1816,0,0
2016/9/5,臺指選擇權,CALL,外資及陸資,32847,109298,29439,103985,3408,5314,100734,763665,59082,533030,41652,230635
2016/9/5,臺指選擇權,PUT,自營商,103846,139043,142492,194261,-38646,-55218,121987,207473,133906,219185,-11919,-11712
2016/9/5,臺指選擇權,PUT,投信,35,40,0,0,35,40,35,40,0,0,35,40
2016/9/5,臺指選擇權,PUT,外資及陸資,29774,66832,29420,71499,354,-4667,142016,122464,64823,135753,77193,-13289
2016/9/6,臺指選擇權,CALL,自營商,105759,215420,100910,222399,4849,-6979,106844,804991,77342,726335,29502,78656
2016/9/6,臺指選擇權,CALL,投信,0,0,0,0,0,0,2350,2422,2350,2422,0,0
2016/9/6,臺指選擇權,CALL,外資及陸資,36482,126680,37105,124786,-623,1894,102282,916390,61257,651976,41025,264414
2016/9/6,臺指選擇權,PUT,自營商,133910,156480,153661,153309,-19751,3171,125142,169751,156883,160382,-31741,9369
2016/9/6,臺指選擇權,PUT,投信,88,92,35,37,53,56,88,99,0,0,88,99
2016/9/6,臺指選擇權,PUT,外資及陸資,35748,70297,30354,70870,5394,-573,147986,98950,65322,100770,82664,-1820
2016/9/7,臺指選擇權,CALL,自營商,190995,482301,189239,421422,1756,60879,83126,897968,59115,729295,24011,168673
2016/9/7,臺指選擇權,CALL,投信,0,0,0,0,0,0,2350,3255,2350,3255,0,0
2016/9/7,臺指選擇權,CALL,外資及陸資,58917,208291,60618,223173,-1701,-14883,101440,1089689,64811,811406,36629,278283
2016/9/7,臺指選擇權,PUT,自營商,180465,189331,234315,222704,-53850,-33373,89830,134820,119481,140754,-29651,-5934
2016/9/7,臺指選擇權,PUT,投信,108,188,88,88,20,100,108,178,0,0,108,178
2016/9/7,臺指選擇權,PUT,外資及陸資,44640,76548,33158,57195,11482,19353,150752,98002,64770,74255,85982,23747
2016/9/8,臺指選擇權,CALL,自營商,67657,125923,74701,178324,-7044,-52401,91406,858759,74509,752181,16897,106578
2016/9/8,臺指選擇權,CALL,投信,0,0,0,0,0,0,2350,3100,2350,3100,0,0
2016/9/8,臺指選擇權,CALL,外資及陸資,20720,78344,21891,84739,-1171,-6395,103512,1058761,68084,791056,35428,267705
2016/9/8,臺指選擇權,PUT,自營商,93103,121068,85678,113609,7425,7459,105868,154536,128101,148103,-22233,6433
2016/9/8,臺指選擇權,PUT,投信,45,76,108,182,-63,-105,45,75,0,0,45,75
2016/9/8,臺指選擇權,PUT,外資及陸資,26711,54234,18830,52978,7881,1256,159751,102461,65856,78157,93895,24304
2016/9/9,臺指選擇權,CALL,自營商,131279,199072,151199,269698,-19920,-70626,97374,664705,100398,656457,-3024,8248
2016/9/9,臺指選擇權,CALL,投信,0,0,0,0,0,0,2350,2007,2350,2007,0,0
2016/9/9,臺指選擇權,CALL,外資及陸資,32475,101668,31121,102342,1354,-674,105470,851022,68660,611798,36810,239224
2016/9/9,臺指選擇權,PUT,自營商,139244,253375,111857,194489,27387,58886,128389,265271,123183,201674,5206,63597
2016/9/9,臺指選擇權,PUT,投信,10,17,45,108,-35,-91,10,17,0,0,10,17
2016/9/9,臺指選擇權,PUT,外資及陸資,35444,111955,33208,105958,2236,5997,163568,146001,67371,111256,96197,34745
2016/9/10,臺指選擇權,CALL,自營商,125830,206593,161761,205444,-35931,1149,102422,533997,141377,530247,-38955,3750
2016/9/10,臺指選擇權,CALL,投信,0,0,0,0,0,0,2350,1411,2350,1411,0,0
2016/9/10,臺指選擇權,CALL,外資及陸資,11717,33242,11061,25933,656,7310,106366,638839,68993,421127,37373,217712
2016/9/10,臺指選擇權,PUT,自營商,164972,457957,172415,477977,-7443,-20021,136296,551304,138553,441295,-2257,110009
2016/9/10,臺指選擇權,PUT,投信,0,0,10,60,-10,-60,0,0,0,0,0,0
2016/9/10,臺指選擇權,PUT,外資及陸資,26081,98052,19483,87412,6598,10640,171204,326264,68422,241798,102782,84466
2016/9/12,臺指選擇權,CALL,自營商,147285,197244,169859,211443,-22574,-14199,107144,491078,168673,496888,-61529,-5810
2016/9/12,臺指選擇權,CALL,投信,0,0,0,0,0,0,2350,1291,2350,1291,0,0
2016/9/12,臺指選擇權,CALL,外資及陸資,39644,75659,32129,74640,7515,1019,111940,589712,67052,381396,44888,208316
2016/9/12,臺指選擇權,PUT,自營商,177329,408893,180193,397154,-2864,11739,139037,694585,144158,530994,-5121,163591
2016/9/12,臺指選擇權,PUT,投信,0,0,0,0,0,0,0,0,0,0,0,0
2016/9/12,臺指選擇權,PUT,外資及陸資,60318,197548,48109,203095,12209,-5547,184530,417353,69539,304212,114991,113141
2016/9/13,臺指選擇權,CALL,自營商,208329,242933,226661,266922,-18332,-23989,112412,489688,192286,506843,-79874,-17155
2016/9/13,臺指選擇權,CALL,投信,0,0,0,0,0,0,2350,1258,2350,1258,0,0
2016/9/13,臺指選擇權,CALL,外資及陸資,60870,131174,57012,127161,3858,4013,118429,596825,69580,380900,48849,215925
2016/9/13,臺指選擇權,PUT,自營商,214340,388649,212659,414576,1681,-25927,145863,612555,149382,476166,-3519,136389
2016/9/13,臺指選擇權,PUT,投信,0,0,0,0,0,0,0,0,0,0,0,0
2016/9/13,臺指選擇權,PUT,外資及陸資,86679,221137,72580,234204,14099,-13067,201958,353803,72825,284623,129133,69180
2016/9/14,臺指選擇權,CALL,自營商,159850,187439,185163,182989,-25313,4451,75447,446307,121178,465334,-45731,-19027
2016/9/14,臺指選擇權,CALL,投信,0,0,0,0,0,0,2350,1157,2350,1157,0,0
2016/9/14,臺指選擇權,CALL,外資及陸資,41920,91741,37122,83999,4798,7742,113978,564754,67799,350238,46179,214516
2016/9/14,臺指選擇權,PUT,自營商,187423,348426,203422,413461,-15999,-65035,124525,516823,116517,400254,8008,116569
2016/9/14,臺指選擇權,PUT,投信,0,0,0,0,0,0,0,0,0,0,0,0
2016/9/14,臺指選擇權,PUT,外資及陸資,61377,154684,58710,149965,2667,4719,191104,348011,73755,300582,117349,47429
2016/9/19,臺指選擇權,CALL,自營商,166131,319401,141011,313081,25120,6320,83515,723251,104062,742849,-20547,-19598
2016/9/19,臺指選擇權,CALL,投信,90,1,90,1,0,0,2440,2006,2440,2006,0,0
2016/9/19,臺指選擇權,CALL,外資及陸資,68307,271269,59941,234376,8366,36893,127032,979203,72476,639816,54556,339387
2016/9/19,臺指選擇權,PUT,自營商,188028,212685,227871,227046,-39843,-14361,127287,182934,159106,170388,-31819,12546
2016/9/19,臺指選擇權,PUT,投信,56,27,0,0,56,27,56,26,0,0,56,26
2016/9/19,臺指選擇權,PUT,外資及陸資,54883,108954,48658,124432,6225,-15478,204574,133376,81012,118329,123562,15047
2016/9/20,臺指選擇權,CALL,自營商,94127,169021,101550,203150,-7423,-34129,86049,688370,113973,738856,-27924,-50486
2016/9/20,臺指選擇權,CALL,投信,0,0,0,0,0,0,2440,1827,2440,1827,0,0
2016/9/20,臺指選擇權,CALL,外資及陸資,36941,114429,36323,117645,618,-3216,122352,923228,67149,602024,55203,321204
2016/9/20,臺指選擇權,PUT,自營商,108716,115482,102704,125462,6012,-9980,140599,184092,166385,181684,-25786,2408
2016/9/20,臺指選擇權,PUT,投信,21,11,56,26,-35,-15,21,11,0,0,21,11
2016/9/20,臺指選擇權,PUT,外資及陸資,32254,62632,32047,71184,207,-8552,204232,138338,80442,133480,123790,4858
2016/9/21,臺指選擇權,CALL,自營商,188047,537281,169020,418264,19027,119017,54007,315948,43344,304052,10663,11896
2016/9/21,臺指選擇權,CALL,投信,100,1,100,1,0,0,890,2161,890,2161,0,0
2016/9/21,臺指選擇權,CALL,外資及陸資,58338,167831,53812,182038,4526,-14208,67838,627050,32418,339999,35420,287051
2016/9/21,臺指選擇權,PUT,自營商,143144,229341,179358,247347,-36214,-18007,56672,114515,57894,133544,-1222,-19029
2016/9/21,臺指選擇權,PUT,投信,36,84,21,10,15,74,36,82,0,0,36,82
2016/9/21,臺指選擇權,PUT,外資及陸資,34875,74589,35772,104216,-897,-29628,58262,128882,43207,152711,15055,-23829
2016/9/22,臺指選擇權,CALL,自營商,107563,195164,97717,186224,9846,8940,73490,330697,53114,303267,20376,27430
2016/9/22,臺指選擇權,CALL,投信,0,0,0,0,0,0,890,1986,890,1986,0,0
2016/9/22,臺指選擇權,CALL,外資及陸資,43037,130098,39521,133578,3516,-3480,73868,621284,34922,339267,38946,282017
2016/9/22,臺指選擇權,PUT,自營商,122814,175560,118457,189393,4357,-13832,75931,121242,72810,141111,3121,-19869
2016/9/22,臺指選擇權,PUT,投信,36,57,24,37,12,20,48,77,0,0,48,77
2016/9/22,臺指選擇權,PUT,外資及陸資,48184,108701,39505,109391,8679,-690,68341,108397,44631,126172,23710,-17775
2016/9/23,臺指選擇權,CALL,自營商,89445,203283,79298,164278,10147,39005,84747,388401,53944,322982,30803,65419
2016/9/23,臺指選擇權,CALL,投信,0,0,0,0,0,0,890,2216,890,2216,0,0
2016/9/23,臺指選擇權,CALL,外資及陸資,29085,103196,28340,101247,745,1949,75049,677216,35307,373426,39742,303790
2016/9/23,臺指選擇權,PUT,自營商,95528,132530,110270,161674,-14742,-29144,75277,101196,86847,133347,-11570,-32151
2016/9/23,臺指選擇權,PUT,投信,33,78,48,54,-15,24,33,78,0,0,33,78
2016/9/23,臺指選擇權,PUT,外資及陸資,30981,71293,26322,70475,4659,818,73234,92184,44859,101455,28375,-9271
2016/9/26,臺指選擇權,CALL,自營商,104042,157200,112224,175495,-8182,-18295,92045,307667,69356,263808,22689,43859
2016/9/26,臺指選擇權,CALL,投信,0,0,0,0,0,0,890,1621,890,1621,0,0
2016/9/26,臺指選擇權,CALL,外資及陸資,32711,81954,30872,90301,1839,-8347,77850,568136,36271,309309,41579,258827
2016/9/26,臺指選擇權,PUT,自營商,108013,167127,104766,184219,3247,-17092,88801,151235,97096,225773,-8295,-74538
2016/9/26,臺指選擇權,PUT,投信,0,0,33,93,-33,-93,0,0,0,0,0,0
2016/9/26,臺指選擇權,PUT,外資及陸資,40234,110860,33358,97728,6876,13133,79334,134205,44098,136659,35236,-2454
2016/9/29,臺指選擇權,CALL,自營商,195350,343449,180745,271203,14605,72246,81153,395508,43554,292202,37599,103306
2016/9/29,臺指選擇權,CALL,投信,0,0,0,0,0,0,890,2116,890,2116,0,0
2016/9/29,臺指選擇權,CALL,外資及陸資,39524,119244,29687,108004,9837,11240,76191,677226,33419,364809,42772,312417
2016/9/29,臺指選擇權,PUT,自營商,192323,225530,230479,278113,-38156,-52583,64727,104954,98619,191814,-33892,-86860
2016/9/29,臺指選擇權,PUT,投信,0,0,0,0,0,0,0,0,0,0,0,0
2016/9/29,臺指選擇權,PUT,外資及陸資,43244,102667,33637,96076,9607,6592,79204,114221,43234,100345,35970,13876
2016/9/30,臺指選擇權,CALL,自營商,116336,188574,118988,226931,-2652,-38357,99029,309686,64153,267432,34876,42254
2016/9/30,臺指選擇權,CALL,投信,0,0,0,0,0,0,890,1511,890,1511,0,0
2016/9/30,臺指選擇權,CALL,外資及陸資,39003,121512,37104,123027,1899,-1515,79744,551588,35093,296817,44651,254771
2016/9/30,臺指選擇權,PUT,自營商,178764,311164,149487,288490,29277,22674,124312,253286,128952,398276,-4640,-144990
2016/9/30,臺指選擇權,PUT,投信,0,0,0,0,0,0,0,0,0,0,0,0
2016/9/30,臺指選擇權,PUT,外資及陸資,60977,171586,48357,168837,12620,2750,94456,194268,45820,172177,48636,22091
2016/10/3,臺指選擇權,CALL,自營商,79566,149728,79702,170861,-136,-21133,109150,369931,74446,347843,34704,22088
2016/10/3,臺指選擇權,CALL,投信,0,0,0,0,0,0,890,1821,890,1821,0,0
2016/10/3,臺指選擇權,CALL,外資及陸資,30932,92788,31286,97186,-354,-4397,79681,618601,35368,338785,44313,279816
2016/10/3,臺指選擇權,PUT,自營商,117526,144655,116180,163071,1346,-18416,138979,189350,142317,298143,-3338,-108793
2016/10/3,臺指選擇權,PUT,投信,0,0,0,0,0,0,0,0,0,0,0,0
2016/10/3,臺指選擇權,PUT,外資及陸資,33712,80785,33712,86694,0,-5908,96111,153327,47471,139945,48640,13382
2016/10/4,臺指選擇權,CALL,自營商,93912,181827,79442,160238,14470,21589,124730,443006,75597,395612,49133,47394
2016/10/4,臺指選擇權,CALL,投信,0,0,0,0,0,0,890,2116,890,2116,0,0
2016/10/4,臺指選擇權,CALL,外資及陸資,31081,102686,31730,104949,-649,-2263,79605,684154,35920,380413,43685,303741
2016/10/4,臺指選擇權,PUT,自營商,112531,119853,121033,132821,-8502,-12967,138525,147661,150432,205848,-11907,-58187
2016/10/4,臺指選擇權,PUT,投信,33,54,0,0,33,54,33,54,0,0,33,54
2016/10/4,臺指選擇權,PUT,外資及陸資,32175,66284,29939,70841,2236,-4557,98516,127948,47639,117063,50877,10885
2016/10/5,臺指選擇權,CALL,自營商,92162,164009,88608,129959,3554,34050,91901,386812,55311,333800,36590,53012
2016/10/5,臺指選擇權,CALL,投信,0,0,0,0,0,0,890,1971,890,1971,0,0
2016/10/5,臺指選擇權,CALL,外資及陸資,24102,73170,24394,77330,-292,-4160,78063,665531,36308,374451,41755,291080
2016/10/5,臺指選擇權,PUT,自營商,106684,128486,118852,138188,-12168,-9702,86517,141360,106723,208370,-20206,-67010
2016/10/5,臺指選擇權,PUT,投信,19,31,33,66,-14,-35,19,30,0,0,19,30
2016/10/5,臺指選擇權,PUT,外資及陸資,22276,48516,20019,51092,2257,-2576,90214,132742,47128,123359,43086,9383
2016/10/6,臺指選擇權,CALL,自營商,70789,123308,75253,169762,-4464,-46454,104255,401596,72220,393240,32035,8356
2016/10/6,臺指選擇權,CALL,投信,0,0,0,0,0,0,890,2026,890,2026,0,0
2016/10/6,臺指選擇權,CALL,外資及陸資,22943,82935,26140,102932,-3197,-19997,79682,678108,41165,402910,38517,275198
2016/10/6,臺指選擇權,PUT,自營商,100788,137844,88755,143133,12033,-5289,105846,135124,113964,189680,-8118,-54556
2016/10/6,臺指選擇權,PUT,投信,0,0,19,29,-19,-29,0,0,0,0,0,0
2016/10/6,臺指選擇權,PUT,外資及陸資,28928,68366,24058,71828,4870,-3463,97651,125105,49653,119009,47998,6096
2016/10/7,臺指選擇權,CALL,自營商,50889,84121,43844,74898,7045,9223,114045,398668,74859,383556,39186,15112
2016/10/7,臺指選擇權,CALL,投信,0,0,0,0,0,0,890,1886,890,1886,0,0
2016/10/7,臺指選擇權,CALL,外資及陸資,15576,53352,14862,58036,714,-4684,81912,667659,42666,402058,39246,265601
2016/10/7,臺指選擇權,PUT,自營商,67145,84337,71880,112219,-4735,-27881,118517,146223,131365,229293,-12848,-83070
2016/10/7,臺指選擇權,PUT,投信,0,0,0,0,0,0,0,0,0,0,0,0
2016/10/7,臺指選擇權,PUT,外資及陸資,20694,49100,21393,60459,-699,-11359,103088,130586,55813,136173,47275,-5587
2016/10/11,臺指選擇權,CALL,自營商,186414,271335,186894,255676,-480,15659,118228,310901,79494,296006,38734,14895
2016/10/11,臺指選擇權,CALL,投信,0,0,0,0,0,0,890,1426,890,1426,0,0
2016/10/11,臺指選擇權,CALL,外資及陸資,57517,157782,50993,152100,6524,5682,88173,580169,42396,337671,45777,242498
2016/10/11,臺指選擇權,PUT,自營商,231196,358813,218995,355263,12201,3550,131011,181423,131645,279709,-634,-98286
2016/10/11,臺指選擇權,PUT,投信,0,0,0,0,0,0,0,0,0,0,0,0
2016/10/11,臺指選擇權,PUT,外資及陸資,77397,206558,66924,200702,10473,5857,113083,158316,55340,153343,57743,4973
2016/10/12,臺指選擇權,CALL,自營商,145635,184264,125020,149849,20615,34415,98259,369641,58817,319665,39442,49976
2016/10/12,臺指選擇權,CALL,投信,0,0,0,0,0,0,890,1663,890,1663,0,0
2016/10/12,臺指選擇權,CALL,外資及陸資,38113,103438,33660,88658,4453,14780,88608,661589,41065,379265,47543,282324
2016/10/12,臺指選擇權,PUT,自營商,159076,185873,175640,205637,-16564,-19763,97909,130473,110504,149613,-12595,-19140
2016/10/12,臺指選擇權,PUT,投信,0,0,0,0,0,0,0,0,0,0,0,0
2016/10/12,臺指選擇權,PUT,外資及陸資,43379,86018,35835,89613,7544,-3595,113566,118353,55867,112995,57699,5358
2016/10/13,臺指選擇權,CALL,自營商,95591,112215,114040,210203,-18449,-97989,110145,298901,89251,351318,20894,-52417
2016/10/13,臺指選擇權,CALL,投信,40,0,40,0,0,0,930,1314,930,1314,0,0
2016/10/13,臺指選擇權,CALL,外資及陸資,37732,117855,42487,135866,-4755,-18011,89255,587567,46467,347269,42788,240298
2016/10/13,臺指選擇權,PUT,自營商,139604,194409,117615,153817,21989,40593,114908,211406,105558,189328,9350,22078
2016/10/13,臺指選擇權,PUT,投信,0,0,0,0,0,0,0,0,0,0,0,0
2016/10/13,臺指選擇權,PUT,外資及陸資,68445,152308,42347,125682,26098,26626,137342,168708,53536,132004,83806,36704
2016/10/14,臺指選擇權,CALL,自營商,86831,122859,89999,120477,-3168,2381,110862,269662,93035,296501,17827,-26839
2016/10/14,臺指選擇權,CALL,投信,0,0,0,0,0,0,930,1139,930,1139,0,0
2016/10/14,臺指選擇權,CALL,外資及陸資,34319,93598,33814,99436,505,-5838,92787,551135,49466,321726,43321,229409
2016/10/14,臺指選擇權,PUT,自營商,91797,163916,88831,153840,2966,10075,121874,241155,109704,210156,12170,30999
2016/10/14,臺指選擇權,PUT,投信,0,0,0,0,0,0,0,0,0,0,0,0
2016/10/14,臺指選擇權,PUT,外資及陸資,43212,119259,37299,116640,5913,2619,144545,186924,54834,147128,89711,39796
2016/10/17,臺指選擇權,CALL,自營商,147866,195341,164918,213348,-17052,-18007,118560,262996,117677,318454,883,-55458
2016/10/17,臺指選擇權,CALL,投信,0,0,0,0,0,0,930,1039,930,1039,0,0
2016/10/17,臺指選擇權,CALL,外資及陸資,64539,167024,65243,158897,-704,8126,94245,553248,51568,319227,42677,234021
2016/10/17,臺指選擇權,PUT,自營商,158995,275798,138472,253719,20523,22079,140581,234719,107736,192818,32845,41901
2016/10/17,臺指選擇權,PUT,投信,0,0,0,0,0,0,0,0,0,0,0,0
2016/10/17,臺指選擇權,PUT,外資及陸資,79798,219109,68327,219840,11471,-731,154573,176350,53374,144487,101199,31863
2016/10/18,臺指選擇權,CALL,自營商,129986,197345,94463,147594,35523,49751,136148,328842,99703,340227,36445,-11385
2016/10/18,臺指選擇權,CALL,投信,100,1,100,1,0,0,1030,1219,1030,1219,0,0
2016/10/18,臺指選擇權,CALL,外資及陸資,34528,102199,29325,90535,5203,11664,96585,615547,48645,354053,47940,261494
2016/10/18,臺指選擇權,PUT,自營商,117032,153471,136981,163468,-19949,-9997,133567,161140,120768,152579,12799,8561
2016/10/18,臺指選擇權,PUT,投信,0,0,0,0,0,0,0,0,0,0,0,0
2016/10/18,臺指選擇權,PUT,外資及陸資,33110,69454,30113,83711,2997,-14257,155186,129360,51057,125753,104129,3607
2016/10/19,臺指選擇權,CALL,自營商,175673,435410,152950,263954,22723,171456,81596,314769,33443,235937,48153,78832
2016/10/19,臺指選擇權,CALL,投信,90,1,90,1,0,0,930,1342,930,1342,0,0
2016/10/19,臺指選擇權,CALL,外資及陸資,45442,129859,38688,111138,6754,18721,72678,624960,30883,316661,41795,308299
2016/10/19,臺指選擇權,PUT,自營商,143974,162442,205108,209810,-61134,-47368,53786,89006,66221,146957,-12435,-57951
2016/10/19,臺指選擇權,PUT,投信,45,108,0,0,45,108,45,104,0,0,45,104
2016/10/19,臺指選擇權,PUT,外資及陸資,34832,55365,31212,72036,3620,-16670,61130,95141,35642,117149,25488,-22008
2016/10/20,臺指選擇權,CALL,自營商,81172,165484,74350,190196,6822,-24712,109931,375725,55014,313899,54917,61826
2016/10/20,臺指選擇權,CALL,投信,0,0,0,0,0,0,930,1405,930,1405,0,0
2016/10/20,臺指選擇權,CALL,外資及陸資,26022,92842,28617,107965,-2595,-15123,73672,646137,34496,342634,39176,303503
2016/10/20,臺指選擇權,PUT,自營商,117792,168789,112316,215454,5476,-46665,93321,110465,100254,200732,-6933,-90267
2016/10/20,臺指選擇權,PUT,投信,29,51,45,95,-16,-43,29,51,0,0,29,51
2016/10/20,臺指選擇權,PUT,外資及陸資,31630,79745,34966,100213,-3336,-20468,65234,83666,43055,123341,22179,-39675
2016/10/21,臺指選擇權,CALL,自營商,70791,148200,63452,121405,7339,26795,118984,368216,56725,293952,62259,74264
2016/10/21,臺指選擇權,CALL,投信,0,0,0,0,0,0,930,1251,930,1251,0,0
2016/10/21,臺指選擇權,CALL,外資及陸資,27166,82699,26113,85955,1053,-3256,78205,631608,37977,337963,40228,293645
2016/10/21,臺指選擇權,PUT,自營商,106648,175111,105648,190836,1000,-15726,105393,118044,111278,225762,-5885,-107718
2016/10/21,臺指選擇權,PUT,投信,0,0,29,53,-29,-53,0,0,0,0,0,0
2016/10/21,臺指選擇權,PUT,外資及陸資,38955,94708,37300,109315,1655,-14607,73514,91918,49665,146965,23849,-55047
2016/10/24,臺指選擇權,CALL,自營商,61988,123955,59019,123100,2969,855,123510,415902,58270,334930,65240,80972
2016/10/24,臺指選擇權,CALL,投信,0,0,0,0,0,0,930,1419,930,1419,0,0
2016/10/24,臺指選擇權,CALL,外資及陸資,26426,84443,25728,84749,698,-306,79180,673552,38213,365265,40967,308287
2016/10/24,臺指選擇權,PUT,自營商,90506,121548,81110,112916,9396,8632,105438,100856,102216,150096,3222,-49240
2016/10/24,臺指選擇權,PUT,投信,0,0,0,0,0,0,0,0,0,0,0,0
2016/10/24,臺指選擇權,PUT,外資及陸資,28234,63095,26363,63666,1871,-571,75109,76361,49386,115482,25723,-39121
2016/10/25,臺指選擇權,CALL,自營商,101102,226541,92945,179994,8157,46547,135631,553515,62100,396393,73531,157122
2016/10/25,臺指選擇權,CALL,投信,40,390,12,115,28,275,958,2082,930,1816,28,266
2016/10/25,臺指選擇權,CALL,外資及陸資,36814,125147,30960,110577,5854,14570,82781,761463,35955,405903,46826,355560
2016/10/25,臺指選擇權,PUT,自營商,113743,136443,120155,124143,-6412,12300,112199,90066,115343,94560,-3144,-4494
2016/10/25,臺指選擇權,PUT,投信,59,81,40,3,19,78,47,81,28,2,19,79
2016/10/25,臺指選擇權,PUT,外資及陸資,32161,65946,27679,63047,4482,2899,81189,65828,50986,84825,30203,-18997
2016/10/26,臺指選擇權,CALL,自營商,108259,176503,114872,181519,-6613,-5015,102178,385087,42358,277690,59820,107397
2016/10/26,臺指選擇權,CALL,投信,0,0,28,225,-28,-225,930,1481,930,1481,0,0
2016/10/26,臺指選擇權,CALL,外資及陸資,33189,85388,28970,80014,4219,5374,81326,691490,34583,360617,46743,330873
2016/10/26,臺指選擇權,PUT,自營商,115099,150037,140946,176067,-25847,-26029,74772,104591,75130,138402,-358,-33811
2016/10/26,臺指選擇權,PUT,投信,28,1,47,94,-19,-93,0,0,0,0,0,0
2016/10/26,臺指選擇權,PUT,外資及陸資,35188,77703,26788,64121,8400,13581,76856,83579,44699,93741,32157,-10162
2016/10/27,臺指選擇權,CALL,自營商,92049,144559,98428,187180,-6379,-42621,110215,329496,56828,283426,53387,46070
2016/10/27,臺指選擇權,CALL,投信,0,0,0,0,0,0,930,1131,930,1131,0,0
2016/10/27,臺指選擇權,CALL,外資及陸資,33521,102006,32651,102735,870,-728,84757,639151,37151,334618,47606,304533
2016/10/27,臺指選擇權,PUT,自營商,109702,182081,92801,171954,16901,10127,98885,136460,82366,174896,16519,-38436
2016/10/27,臺指選擇權,PUT,投信,0,0,0,0,0,0,0,0,0,0,0,0
2016/10/27,臺指選擇權,PUT,外資及陸資,49156,110795,33337,97946,15819,12849,91745,104972,43789,106415,47956,-1443
2016/10/28,臺指選擇權,CALL,自營商,63531,108949,62718,107754,813,1195,114968,326940,60679,281041,54289,45899
2016/10/28,臺指選擇權,CALL,投信,0,0,0,0,0,0,930,1111,930,1111,0,0
2016/10/28,臺指選擇權,CALL,外資及陸資,23547,68771,21298,65455,2249,3315,87610,634718,37675,329965,49935,304753
2016/10/28,臺指選擇權,PUT,自營商,87764,120904,87465,134784,299,-13881,106526,139531,89728,189317,16798,-49786
2016/10/28,臺指選擇權,PUT,投信,0,0,0,0,0,0,0,0,0,0,0,0
2016/10/28,臺指選擇權,PUT,外資及陸資,35671,84000,23478,65699,12193,18301,104979,130296,44851,114176,60128,16120
2016/10/31,臺指選擇權,CALL,自營商,124591,191954,130391,177245,-5800,14709,116099,359647,67670,281390,48429,78257
2016/10/31,臺指選擇權,CALL,投信,20,14,0,0,20,14,950,1180,930,1151,20,29
2016/10/31,臺指選擇權,CALL,外資及陸資,47051,121157,42202,117728,4849,3429,93545,663862,38829,342966,54716,320896
2016/10/31,臺指選擇權,PUT,自營商,156376,296133,157600,263573,-1224,32561,108300,142107,92703,171014,15597,-28907
2016/10/31,臺指選擇權,PUT,投信,0,0,20,63,-20,-63,0,0,20,35,-20,-35
2016/10/31,臺指選擇權,PUT,外資及陸資,70213,185902,48138,144142,22075,41761,125235,156406,43003,110963,82232,45443
2016/11/1,臺指選擇權,CALL,自營商,96792,123166,102904,179378,-6112,-56212,118844,338981,76595,320656,42249,18325
2016/11/1,臺指選擇權,CALL,投信,0,0,0,0,0,0,950,1197,930,1179,20,18
2016/11/1,臺指選擇權,CALL,外資及陸資,31903,89149,29941,81544,1962,7605,96616,672552,39935,344582,56681,327970
2016/11/1,臺指選擇權,PUT,自營商,122550,193694,112560,161504,9990,32190,117190,158638,91649,153272,25541,5366
2016/11/1,臺指選擇權,PUT,投信,0,0,0,0,0,0,0,0,20,26,-20,-26
2016/11/1,臺指選擇權,PUT,外資及陸資,37958,103720,31741,84164,6217,19556,131791,177285,43378,114662,88413,62623
2016/11/2,臺指選擇權,CALL,自營商,188392,229849,246465,282009,-58073,-52160,107751,256610,77925,293927,29826,-37317
2016/11/2,臺指選擇權,CALL,投信,27,32,10,4,17,28,956,862,930,829,26,33
2016/11/2,臺指選擇權,CALL,外資及陸資,44940,98693,42082,102970,2858,-4277,95980,546374,41977,285164,54003,261210
2016/11/2,臺指選擇權,PUT,自營商,222878,567186,211077,432926,11801,134259,92644,259485,71577,223753,21067,35732
2016/11/2,臺指選擇權,PUT,投信,20,149,0,0,20,149,0,0,0,0,0,0
2016/11/2,臺指選擇權,PUT,外資及陸資,78703,227261,66991,210466,11712,16795,131343,322972,43527,189010,87816,133962
2016/11/3,臺指選擇權,CALL,自營商,100202,181651,102079,191581,-1877,-9929,116775,230375,88783,259756,27992,-29381
2016/11/3,臺指選擇權,CALL,投信,21,36,26,25,-5,10,951,664,930,628,21,36
2016/11/3,臺指選擇權,CALL,外資及陸資,29440,86374,29579,97191,-139,-10817,96617,470779,42711,249955,53906,220824
2016/11/3,臺指選擇權,PUT,自營商,96413,254145,92444,269721,3969,-15577,106515,332530,81494,308133,25021,24397
2016/11/3,臺指選擇權,PUT,投信,0,0,0,0,0,0,0,0,0,0,0,0
2016/11/3,臺指選擇權,PUT,外資及陸資,41838,146802,38525,162502,3313,-15700,138274,394387,47125,240286,91149,154101
2016/11/4,臺指選擇權,CALL,自營商,69438,122561,86517,141670,-17079,-19109,114055,223200,103149,264476,10906,-41276
2016/11/4,臺指選擇權,CALL,投信,0,0,21,33,-21,-33,930,591,930,591,0,0
2016/11/4,臺指選擇權,CALL,外資及陸資,25433,69067,23718,72305,1715,-3238,101753,456129,46130,245651,55623,210478
2016/11/4,臺指選擇權,PUT,自營商,79681,214217,82231,217737,-2550,-3520,110406,351724,88001,328701,22405,23023
2016/11/4,臺指選擇權,PUT,投信,0,0,0,0,0,0,0,0,0,0,0,0
2016/11/4,臺指選擇權,PUT,外資及陸資,53792,156721,34932,126134,18860,30587,163739,477027,53722,273788,110017,203239
2016/11/7,臺指選擇權,CALL,自營商,109202,240334,108264,217845,938,22489,124647,345387,112938,401989,11709,-56602
2016/11/7,臺指選擇權,CALL,投信,20,65,0,0,20,65,950,913,930,839,20,74
2016/11/7,臺指選擇權,CALL,外資及陸資,28062,83531,25556,97324,2506,-13793,109872,583259,51765,343296,58107,239963
2016/11/7,臺指選擇權,PUT,自營商,117881,201293,119309,225823,-1428,-24530,127470,228418,106544,220864,20926,7554
2016/11/7,臺指選擇權,PUT,投信,0,0,20,72,-20,-72,0,0,20,66,-20,-66
2016/11/7,臺指選擇權,PUT,外資及陸資,48317,93319,32822,84222,15495,9098,177669,280648,52172,169076,125497,111572
2016/11/8,臺指選擇權,CALL,自營商,109829,205151,108628,189379,1201,15772,133030,357213,120080,401748,12950,-44535
2016/11/8,臺指選擇權,CALL,投信,0,0,8,28,-8,-28,942,887,930,841,12,46
2016/11/8,臺指選擇權,CALL,外資及陸資,47517,119017,35344,121188,12173,-2171,124185,614373,53849,368453,70336,245920
2016/11/8,臺指選擇權,PUT,自營商,117767,189181,127966,200334,-10199,-11153,132511,207652,121804,205692,10707,1960
2016/11/8,臺指選擇權,PUT,投信,8,20,0,0,8,20,0,0,12,28,-12,-28
2016/11/8,臺指選擇權,PUT,外資及陸資,65000,119951,37325,107704,27675,12247,206738,266429,53573,162238,153165,104191
2016/11/9,臺指選擇權,CALL,自營商,409904,780803,510316,801599,-100412,-20796,100774,187415,103528,198719,-2754,-11304
2016/11/9,臺指選擇權,CALL,投信,204,504,16,20,188,484,1130,772,930,357,200,415
2016/11/9,臺指選擇權,CALL,外資及陸資,171283,376119,176895,419057,-5612,-42938,95348,344590,58875,199879,36473,144711
2016/11/9,臺指選擇權,PUT,自營商,524221,1443125,545095,1444071,-20874,-946,89131,446667,94066,559927,-4935,-113260
2016/11/9,臺指選擇權,PUT,投信,12,27,0,0,12,27,0,0,0,0,0,0
2016/11/9,臺指選擇權,PUT,外資及陸資,253360,909444,243328,917978,10032,-8534,159330,738710,57839,426287,101491,312423
2016/11/10,臺指選擇權,CALL,自營商,148596,253946,143933,299612,4663,-45666,108293,291603,106042,342184,2251,-50581
2016/11/10,臺指選擇權,CALL,投信,0,0,0,0,0,0,1130,1612,930,472,200,1140
2016/11/10,臺指選擇權,CALL,外資及陸資,51247,180151,53429,180890,-2182,-739,96543,486630,62280,314688,34263,171942
2016/11/10,臺指選擇權,PUT,自營商,151206,201707,157548,206859,-6342,-5152,105630,169366,116446,183646,-10816,-14280
2016/11/10,臺指選擇權,PUT,投信,0,0,0,0,0,0,0,0,0,0,0,0
2016/11/10,臺指選擇權,PUT,外資及陸資,60012,121959,40000,111220,20012,10739,178576,188631,56962,133701,121614,54930
2016/11/11,臺指選擇權,CALL,自營商,162943,242171,198116,235797,-35173,6374,109051,202940,141996,218750,-32945,-15810
2016/11/11,臺指選擇權,CALL,投信,0,0,0,0,0,0,1130,473,930,238,200,235
2016/11/11,臺指選擇權,CALL,外資及陸資,55900,146529,65534,172980,-9634,-26451,99143,341293,74636,215635,24507,125658
2016/11/11,臺指選擇權,PUT,自營商,180038,508217,180591,478285,-553,29932,106068,422145,117441,447802,-11373,-25657
2016/11/11,臺指選擇權,PUT,投信,0,0,0,0,0,0,0,0,0,0,0,0
2016/11/11,臺指選擇權,PUT,外資及陸資,99329,344951,82906,325925,16423,19026,197819,592937,59704,336153,138115,256784
2016/11/14,臺指選擇權,CALL,自營商,181211,260255,186961,265159,-5750,-4904,113407,198730,151875,208421,-38468,-9691
2016/11/14,臺指選擇權,CALL,投信,0,0,0,0,0,0,1130,327,930,212,200,115
2016/11/14,臺指選擇權,CALL,外資及陸資,48818,127327,48255,121704,563,5623,104286,350362,79220,208018,25066,142344
2016/11/14,臺指選擇權,PUT,自營商,167338,371891,155432,383752,11906,-11861,121364,418880,120903,450552,461,-31672
2016/11/14,臺指選擇權,PUT,投信,10,7,0,0,10,7,10,7,0,0,10,7
2016/11/14,臺指選擇權,PUT,外資及陸資,68000,190053,62835,182584,5165,7469,202245,580409,58939,339213,143306,241196
2016/11/15,臺指選擇權,CALL,自營商,133464,165104,129636,174939,3828,-9835,119412,183139,154010,195176,-34598,-12037
2016/11/15,臺指選擇權,CALL,投信,115,1,115,1,0,0,1245,181,1045,166,200,15
2016/11/15,臺指選擇權,CALL,外資及陸資,41615,102230,36118,94870,5497,7360,107873,336545,77409,182118,30464,154427
2016/11/15,臺指選擇權,PUT,自營商,114744,196820,125275,252262,-10531,-55441,117506,387281,127602,469093,-10096,-81812
2016/11/15,臺指選擇權,PUT,投信,10,5,10,8,0,-4,12,5,2,0,10,5
2016/11/15,臺指選擇權,PUT,外資及陸資,53253,187802,48867,172373,4386,15430,213077,613172,65276,384923,147801,228249
2016/11/16,臺指選擇權,CALL,自營商,149344,253022,169411,264634,-20067,-11612,55243,159923,47170,191274,8073,-31351
2016/11/16,臺指選擇權,CALL,投信,145,1,145,1,0,0,960,108,960,108,0,0
2016/11/16,臺指選擇權,CALL,外資及陸資,37647,88129,32411,80195,5236,7934,75689,345810,29181,183373,46508,162437
2016/11/16,臺指選擇權,PUT,自營商,148441,215527,166088,240451,-17647,-24924,46939,160614,59544,190846,-12605,-30232
2016/11/16,臺指選擇權,PUT,投信,0,0,10,0,-10,0,0,0,0,0,0,0
2016/11/16,臺指選擇權,PUT,外資及陸資,34175,89080,31609,82770,2566,6310,102452,330063,43279,230877,59173,99186
2016/11/17,臺指選擇權,CALL,自營商,77912,143619,77937,158606,-25,-14987,70366,195174,62456,244624,7910,-49450
2016/11/17,臺指選擇權,CALL,投信,0,0,0,0,0,0,960,84,960,84,0,0
2016/11/17,臺指選擇權,CALL,外資及陸資,27094,88179,26167,87428,927,752,79918,359380,32500,197431,47418,161949
2016/11/17,臺指選擇權,PUT,自營商,92609,160417,88301,202157,4308,-41740,76277,177657,84577,241381,-8300,-63724
2016/11/17,臺指選擇權,PUT,投信,0,0,0,0,0,0,0,0,0,0,0,0
2016/11/17,臺指選擇權,PUT,外資及陸資,36196,121064,30105,99526,6091,21538,111726,338526,46450,229573,65276,108953
2016/11/18,臺指選擇權,CALL,自營商,76651,154853,70511,135292,6140,19561,79554,229365,65484,263728,14070,-34363
2016/11/18,臺指選擇權,CALL,投信,0,0,0,0,0,0,960,84,960,84,0,0
2016/11/18,臺指選擇權,CALL,外資及陸資,29370,96421,25807,86076,3563,10345,84036,383637,33054,205555,50982,178082
2016/11/18,臺指選擇權,PUT,自營商,94269,153490,96845,167678,-2576,-14188,84889,168083,95875,228557,-10986,-60474
2016/11/18,臺指選擇權,PUT,投信,32,54,0,0,32,54,32,54,0,0,32,54
2016/11/18,臺指選擇權,PUT,外資及陸資,33628,99712,29562,86767,4066,12946,116264,308639,46933,201070,69331,107569
2016/11/21,臺指選擇權,CALL,自營商,53749,109279,55434,107835,-1685,1444,81978,252767,69634,290066,12344,-37299
2016/11/21,臺指選擇權,CALL,投信,0,0,0,0,0,0,960,83,960,83,0,0
2016/11/21,臺指選擇權,CALL,外資及陸資,22446,67510,20606,64744,1840,2766,86785,406230,33962,219754,52823,186476
2016/11/21,臺指選擇權,PUT,自營商,71142,109527,73985,117949,-2843,-8422,93342,160143,107193,209625,-13851,-49482
2016/11/21,臺指選擇權,PUT,投信,48,88,32,51,16,36,48,86,0,0,48,86
2016/11/21,臺指選擇權,PUT,外資及陸資,24284,65253,21942,58588,2342,6665,120227,279315,48547,179785,71680,99530
2016/11/22,臺指選擇權,CALL,自營商,138134,302252,116388,264577,21746,37676,101379,403307,67289,384656,34090,18651
2016/11/22,臺指選擇權,CALL,投信,0,0,0,0,0,0,960,142,960,142,0,0
2016/11/22,臺指選擇權,CALL,外資及陸資,51137,166232,41024,133837,10113,32395,96656,541922,33722,272450,62934,269472
2016/11/22,臺指選擇權,PUT,自營商,150029,182202,181995,210923,-31966,-28721,85130,114605,130883,160666,-45753,-46061
2016/11/22,臺指選擇權,PUT,投信,42,80,48,71,-6,9,42,83,0,0,42,83
2016/11/22,臺指選擇權,PUT,外資及陸資,37902,85141,33883,77743,4019,7398,127483,192615,51771,121947,75712,70668
2016/11/23,臺指選擇權,CALL,自營商,102111,194245,99178,181089,2933,13156,90695,364937,58674,332685,32021,32252
2016/11/23,臺指選擇權,CALL,投信,0,0,0,0,0,0,960,138,960,138,0,0
2016/11/23,臺指選擇權,CALL,外資及陸資,34389,94784,27782,83254,6607,11530,100965,574424,32089,272120,68876,302304
2016/11/23,臺指選擇權,PUT,自營商,107539,128903,132097,154828,-24558,-25925,67014,104126,104331,161827,-37317,-57701
2016/11/23,臺指選擇權,PUT,投信,40,59,42,72,-2,-13,40,60,0,0,40,60
2016/11/23,臺指選擇權,PUT,外資及陸資,28813,63052,23324,50561,5489,12492,130170,174590,47952,104477,82218,70113
2016/11/24,臺指選擇權,CALL,自營商,61190,114916,64343,132138,-3153,-17222,98474,339354,69746,338650,28728,704
2016/11/24,臺指選擇權,CALL,投信,0,0,0,0,0,0,960,96,960,96,0,0
2016/11/24,臺指選擇權,CALL,外資及陸資,20454,65797,19897,64009,557,1787,102820,534598,33402,256349,69418,278249
2016/11/24,臺指選擇權,PUT,自營商,79120,115754,70401,126947,8719,-11193,82880,128763,111515,204107,-28635,-75344
2016/11/24,臺指選擇權,PUT,投信,48,77,40,65,8,12,48,77,0,0,48,77
2016/11/24,臺指選擇權,PUT,外資及陸資,33869,81526,25910,72670,7959,8856,138418,196989,48221,113243,90197,83746
2016/11/25,臺指選擇權,CALL,自營商,60122,131568,51345,96264,8777,35303,106496,376117,69011,341974,37485,34143
2016/11/25,臺指選擇權,CALL,投信,0,0,0,0,0,0,960,98,960,98,0,0
2016/11/25,臺指選擇權,CALL,外資及陸資,23023,76783,21678,77197,1345,-414,104425,552401,33658,265613,70767,286788
2016/11/25,臺指選擇權,PUT,自營商,81854,111348,82487,124666,-633,-13318,91490,122042,120794,197806,-29304,-75764
2016/11/25,臺指選擇權,PUT,投信,78,109,48,77,30,33,78,111,0,0,78,111
2016/11/25,臺指選擇權,PUT,外資及陸資,26556,63432,22803,65398,3753,-1966,142923,179890,48976,105377,93947,74513
2016/11/28,臺指選擇權,CALL,自營商,88423,161667,78904,159421,9519,2246,116514,454864,69483,391893,47031,62971
2016/11/28,臺指選擇權,CALL,投信,0,0,0,0,0,0,960,148,960,148,0,0
2016/11/28,臺指選擇權,CALL,外資及陸資,37648,126885,34635,123379,3013,3506,108720,641514,34914,307531,73806,333983
2016/11/28,臺指選擇權,PUT,自營商,119175,142818,128939,162695,-9764,-19878,89963,101216,128959,164478,-38996,-63262
2016/11/28,臺指選擇權,PUT,投信,67,99,78,107,-11,-8,67,101,0,0,67,101
2016/11/28,臺指選擇權,PUT,外資及陸資,33425,81897,34949,85587,-1524,-3689,145882,153709,53369,93094,92513,60615
2016/11/29,臺指選擇權,CALL,自營商,81170,110923,77205,117338,3965,-6415,121527,412075,70637,369350,50890,42725
2016/11/29,臺指選擇權,CALL,投信,0,0,0,0,0,0,960,109,960,109,0,0
2016/11/29,臺指選擇權,CALL,外資及陸資,27478,81085,28714,82627,-1236,-1542,109384,609273,36852,295189,72532,314084
2016/11/29,臺指選擇權,PUT,自營商,100538,123401,98127,127316,2411,-3915,91958,115725,128522,187138,-36564,-71413
2016/11/29,臺指選擇權,PUT,投信,15,24,67,99,-52,-75,15,24,0,0,15,24
2016/11/29,臺指選擇權,PUT,外資及陸資,30965,79324,27452,66030,3513,13294,150410,182660,54380,104147,96030,78513
2016/11/30,臺指選擇權,CALL,自營商,124856,198587,126517,166413,-1661,32174,108128,435481,62883,364806,45245,70675
2016/11/30,臺指選擇權,CALL,投信,0,0,0,0,0,0,960,110,960,110,0,0
2016/11/30,臺指選擇權,CALL,外資及陸資,29077,79626,29360,81797,-283,-2171,108162,636758,36417,306351,71745,330407
2016/11/30,臺指選擇權,PUT,自營商,137527,169544,147791,179863,-10264,-10318,70145,103178,119017,172753,-48872,-69575
2016/11/30,臺指選擇權,PUT,投信,0,0,15,20,-15,-20,0,0,0,0,0,0
2016/11/30,臺指選擇權,PUT,外資及陸資,34784,73276,35471,75751,-687,-2474,144298,169312,57141,96398,87157,72914
2016/12/1,臺指選擇權,CALL,自營商,68598,126758,63083,129290,5515,-2532,115649,480973,64879,397692,50770,83281
2016/12/1,臺指選擇權,CALL,投信,0,0,0,0,0,0,960,133,960,133,0,0
2016/12/1,臺指選擇權,CALL,外資及陸資,32487,97046,27677,99117,4810,-2071,113511,679003,36936,326854,76575,352149
2016/12/1,臺指選擇權,PUT,自營商,96029,127795,101830,139020,-5801,-11225,79526,98189,134106,158226,-54580,-60037
2016/12/1,臺指選擇權,PUT,投信,0,0,0,0,0,0,0,0,0,0,0,0
2016/12/1,臺指選擇權,PUT,外資及陸資,34352,73236,30481,75212,3871,-1976,151732,147183,60650,86284,91082,60899
2016/12/2,臺指選擇權,CALL,自營商,91612,146396,113261,202800,-21649,-56404,116463,363051,87422,385851,29041,-22800
2016/12/2,臺指選擇權,CALL,投信,0,0,0,0,0,0,960,71,960,71,0,0
2016/12/2,臺指選擇權,CALL,外資及陸資,35168,82646,29837,89315,5331,-6669,120794,544680,38972,270172,81822,274508
2016/12/2,臺指選擇權,PUT,自營商,128654,253923,114257,230398,14397,23524,96710,185191,136735,268831,-40025,-83640
2016/12/2,臺指選擇權,PUT,投信,0,0,0,0,0,0,0,0,0,0,0,0
2016/12/2,臺指選擇權,PUT,外資及陸資,45415,132825,34813,108906,10602,23919,163677,245172,61930,133380,101747,111792
2016/12/5,臺指選擇權,CALL,自營商,115819,220415,117477,219997,-1658,418,116738,337432,89437,358487,27301,-21055
2016/12/5,臺指選擇權,CALL,投信,0,0,0,0,0,0,960,55,960,55,0,0
2016/12/5,臺指選擇權,CALL,外資及陸資,24704,70818,27973,78876,-3269,-8058,118942,517379,40381,261980,78561,255399
2016/12/5,臺指選擇權,PUT,自營商,103137,165972,96808,179267,6329,-13295,111767,176245,145369,270555,-33602,-94310
2016/12/5,臺指選擇權,PUT,投信,0,0,0,0,0,0,0,0,0,0,0,0
2016/12/5,臺指選擇權,PUT,外資及陸資,33851,97076,31005,93288,2846,3788,168481,238903,63914,133144,104567,105759
2016/12/6,臺指選擇權,CALL,自營商,101821,231595,82106,138600,19715,92994,131610,510751,84505,428117,47105,82634
2016/12/6,臺指選擇權,CALL,投信,0,0,0,0,0,0,960,83,960,83,0,0
2016/12/6,臺指選擇權,CALL,外資及陸資,33915,103779,28388,97631,5527,6148,125166,642356,40962,325220,84204,317136
2016/12/6,臺指選擇權,PUT,自營商,103243,105123,136501,142239,-33258,-37116,106043,94812,172843,166531,-66800,-71719
2016/12/6,臺指選擇權,PUT,投信,0,0,0,0,0,0,0,0,0,0,0,0
2016/12/6,臺指選擇權,PUT,外資及陸資,33678,101842,28398,86119,5280,15723,178339,192318,68561,109691,109778,82627
2016/12/7,臺指選擇權,CALL,自營商,84451,108012,107711,157568,-23260,-49556,95009,431701,73639,400217,21370,31484
2016/12/7,臺指選擇權,CALL,投信,0,0,0,0,0,0,960,77,960,77,0,0
2016/12/7,臺指選擇權,CALL,外資及陸資,29200,69870,28693,74986,507,-5115,123292,634606,41513,325210,81779,309396
2016/12/7,臺指選擇權,PUT,自營商,127055,137090,142705,149155,-15650,-12064,77573,80378,138453,164427,-60880,-84049
2016/12/7,臺指選擇權,PUT,投信,0,0,0,0,0,0,0,0,0,0,0,0
2016/12/7,臺指選擇權,PUT,外資及陸資,29632,61735,30280,65364,-648,-3630,175056,188701,71316,112388,103740,76313
2016/12/8,臺指選擇權,CALL,自營商,101446,245384,98761,263958,2685,-18575,97824,579236,73706,497112,24118,82124
2016/12/8,臺指選擇權,CALL,投信,0,0,0,0,0,0,960,210,960,210,0,0
2016/12/8,臺指選擇權,CALL,外資及陸資,29053,100196,30933,122300,-1880,-22104,122953,809786,43053,423945,79900,385841
2016/12/8,臺指選擇權,PUT,自營商,125595,144100,128094,150575,-2499,-6475,81801,61306,145232,110844,-63431,-49538
2016/12/8,臺指選擇權,PUT,投信,24,20,0,0,24,20,24,20,0,0,24,20
2016/12/8,臺指選擇權,PUT,外資及陸資,29222,58257,22178,60700,7044,-2443,184520,145424,73735,91172,110785,54252
2016/12/9,臺指選擇權,CALL,自營商,48005,93975,45631,107474,2374,-13499,102647,609446,76142,525023,26505,84423
2016/12/9,臺指選擇權,CALL,投信,0,0,0,0,0,0,960,256,960,256,0,0
2016/12/9,臺指選擇權,CALL,外資及陸資,20300,69636,22137,77973,-1837,-8337,123483,850064,45481,450956,78002,399108
2016/12/9,臺指選擇權,PUT,自營商,81024,75303,78467,94120,2557,-18817,91581,60458,152461,115391,-60880,-54933
2016/12/9,臺指選擇權,PUT,投信,40,49,24,19,16,30,40,47,0,0,40,47
2016/12/9,臺指選擇權,PUT,外資及陸資,26439,61336,23461,56846,2978,4490,192191,151547,78367,96619,113824,54928
2016/12/12,臺指選擇權,CALL,自營商,99399,166943,102071,197383,-2672,-30439,105241,517515,81414,481335,23827,36180
2016/12/12,臺指選擇權,CALL,投信,0,0,0,0,0,0,960,130,960,130,0,0
2016/12/12,臺指選擇權,CALL,外資及陸資,38715,122918,41003,125093,-2288,-2175,123486,775062,47736,409398,75750,365664
2016/12/12,臺指選擇權,PUT,自營商,135314,153993,119803,146186,15511,7807,103615,79166,148972,129059,-45357,-49893
2016/12/12,臺指選擇權,PUT,投信,4,5,40,40,-36,-35,4,5,0,0,4,5
2016/12/12,臺指選擇權,PUT,外資及陸資,51896,135253,44475,114959,7421,20294,207355,214268,86122,135953,121233,78315
2016/12/13,臺指選擇權,CALL,自營商,48857,70631,47252,74098,1605,-3467,107982,545060,82650,504172,25332,40888
2016/12/13,臺指選擇權,CALL,投信,0,0,0,0,0,0,960,127,960,127,0,0
2016/12/13,臺指選擇權,CALL,外資及陸資,15756,49934,19064,60128,-3308,-10194,123638,808368,51203,439724,72435,368644
2016/12/13,臺指選擇權,PUT,自營商,67713,71432,63678,77681,4035,-6249,104017,63288,145339,103133,-41322,-39845
2016/12/13,臺指選擇權,PUT,投信,8,7,4,5,4,2,8,7,0,0,8,7
2016/12/13,臺指選擇權,PUT,外資及陸資,21252,48297,19577,47905,1675,392,211582,197537,88663,127417,122919,70120
2016/12/14,臺指選擇權,CALL,自營商,93081,137439,105673,145641,-12592,-8202,87308,499397,76708,472063,10600,27334
2016/12/14,臺指選擇權,CALL,投信,0,0,0,0,0,0,960,102,960,102,0,0
2016/12/14,臺指選擇權,CALL,外資及陸資,31895,80773,30048,79017,1847,1757,127912,793508,53448,430034,74464,363474
2016/12/14,臺指選擇權,PUT,自營商,110129,113305,117792,122333,-7663,-9028,74372,69478,131056,111289,-56684,-41811
2016/12/14,臺指選擇權,PUT,投信,0,0,8,6,-8,-6,0,0,0,0,0,0
2016/12/14,臺指選擇權,PUT,外資及陸資,35590,78855,34244,83272,1346,-4417,208159,219226,92087,151292,116072,67934
2016/12/15,臺指選擇權,CALL,自營商,78176,111205,77865,133328,311,-22123,94440,465007,83578,476011,10862,-11004
2016/12/15,臺指選擇權,CALL,投信,0,0,0,0,0,0,960,28,960,28,0,0
2016/12/15,臺指選擇權,CALL,外資及陸資,33965,97827,34088,93816,-123,4011,132349,775918,58045,421938,74304,353980
2016/12/15,臺指選擇權,PUT,自營商,99413,132845,88107,119119,11306,13726,89240,68691,134477,94499,-45237,-25808
2016/12/15,臺指選擇權,PUT,投信,0,0,0,0,0,0,0,0,0,0,0,0
2016/12/15,臺指選擇權,PUT,外資及陸資,52890,95924,30497,82336,22393,13587,228107,204982,89586,136002,138521,68980
2016/12/16,臺指選擇權,CALL,自營商,59406,81834,68081,129834,-8675,-47999,91022,372747,88919,427952,2103,-55205
2016/12/16,臺指選擇權,CALL,投信,0,0,0,0,0,0,960,14,960,14,0,0
2016/12/16,臺指選擇權,CALL,外資及陸資,21364,63199,23863,75976,-2499,-12776,130415,660692,58606,361183,71809,299509
2016/12/16,臺指選擇權,PUT,自營商,77469,95859,62118,89315,15351,6543,101135,106349,131003,122813,-29868,-16464
2016/12/16,臺指選擇權,PUT,投信,0,0,0,0,0,0,0,0,0,0,0,0
2016/12/16,臺指選擇權,PUT,外資及陸資,21015,53531,22804,57196,-1789,-3665,228014,236104,91279,162867,136735,73237
2016/12/19,臺指選擇權,CALL,自營商,97606,110610,90095,111380,7511,-770,95880,298289,86270,352641,9610,-54352
2016/12/19,臺指選擇權,CALL,投信,0,0,0,0,0,0,960,10,960,10,0,0
2016/12/19,臺指選擇權,CALL,外資及陸資,29848,72293,28547,72494,1301,-201,129964,547911,56825,294777,73139,253134
2016/12/19,臺指選擇權,PUT,自營商,88699,131140,95150,160767,-6451,-29627,108088,139352,144418,196324,-36330,-56972
2016/12/19,臺指選擇權,PUT,投信,0,0,0,0,0,0,0,0,0,0,0,0
2016/12/19,臺指選擇權,PUT,外資及陸資,34089,87781,32790,89869,1299,-2088,231301,283791,93295,203254,138006,80537
2016/12/20,臺指選擇權,CALL,自營商,76982,84955,90967,107515,-13985,-22560,95288,310884,99655,390853,-4367,-79969
2016/12/20,臺指選擇權,CALL,投信,133,30,105,9,28,21,1093,37,1065,16,28,21
2016/12/20,臺指選擇權,CALL,外資及陸資,28189,61587,28737,66504,-548,-4917,132377,567565,59838,314546,72539,253019
2016/12/20,臺指選擇權,PUT,自營商,96185,172616,85265,115497,10920,57118,109092,128085,134464,131476,-25372,-3391
2016/12/20,臺指選擇權,PUT,投信,0,0,0,0,0,0,0,0,0,0,0,0
2016/12/20,臺指選擇權,PUT,外資及陸資,33083,87272,36453,93663,-3370,-6390,230094,240560,95418,181798,134676,58762
2016/12/21,臺指選擇權,CALL,自營商,80925,105595,105297,133730,-24372,-28135,40713,97409,41569,82367,-856,15042
2016/12/21,臺指選擇權,CALL,投信,275,207,303,394,-28,-187,380,183,380,340,0,-157
2016/12/21,臺指選擇權,CALL,外資及陸資,21082,55969,23608,57248,-2526,-1278,49459,179210,25018,77742,24441,101468
2016/12/21,臺指選擇權,PUT,自營商,94238,149369,105034,160885,-10796,-11516,38231,66019,42937,93256,-4706,-27237
2016/12/21,臺指選擇權,PUT,投信,140,207,140,306,0,-99,140,221,140,329,0,-108
2016/12/21,臺指選擇權,PUT,外資及陸資,23228,55809,21794,53484,1434,2326,65510,232537,34443,157092,31067,75445
2016/12/22,臺指選擇權,CALL,自營商,99664,122917,98809,139907,855,-16990,55414,91803,55414,71283,0,20520
2016/12/22,臺指選擇權,CALL,投信,0,0,0,0,0,0,380,75,380,158,0,-83
2016/12/22,臺指選擇權,CALL,外資及陸資,32758,82993,33105,89571,-347,-6578,53494,137571,29410,59604,24084,77967
2016/12/22,臺指選擇權,PUT,自營商,103626,169556,87044,183881,16582,-14325,66262,117322,54389,172416,11873,-55094
2016/12/22,臺指選擇權,PUT,投信,0,0,0,0,0,0,140,312,140,483,0,-171
2016/12/22,臺指選擇權,PUT,外資及陸資,47139,138914,34921,119938,12218,18976,79528,323033,36204,209616,43324,113417
2016/12/23,臺指選擇權,CALL,自營商,95882,120420,94013,130550,1869,-10130,62721,86889,60927,68302,1794,18587
2016/12/23,臺指選擇權,CALL,投信,0,0,0,0,0,0,380,59,380,124,0,-65
2016/12/23,臺指選擇權,CALL,外資及陸資,27514,70916,30223,79516,-2709,-8600,55499,123566,34170,58984,21329,64582
2016/12/23,臺指選擇權,PUT,自營商,90472,166340,86816,173446,3656,-7106,77470,146416,61695,218736,15775,-72320
2016/12/23,臺指選擇權,PUT,投信,0,0,0,0,0,0,140,364,140,553,0,-189
2016/12/23,臺指選擇權,PUT,外資及陸資,30564,108378,30678,109105,-114,-727,81072,360310,37808,237500,43264,122810
2016/12/26,臺指選擇權,CALL,自營商,66626,76678,59388,76001,7238,677,72128,101737,63102,81978,9026,19759
2016/12/26,臺指選擇權,CALL,投信,0,0,0,0,0,0,380,59,380,129,0,-70
2016/12/26,臺指選擇權,CALL,外資及陸資,20439,43346,16464,41429,3975,1917,57549,135497,32232,64592,25317,70905
2016/12/26,臺指選擇權,PUT,自營商,75789,119783,66553,93054,9236,26729,85893,123710,60867,157389,25026,-33679
2016/12/26,臺指選擇權,PUT,投信,0,0,0,0,0,0,140,273,140,434,0,-161
2016/12/26,臺指選擇權,PUT,外資及陸資,18972,53173,16577,52397,2395,775,84129,320153,38479,210194,45650,109959
2016/12/27,臺指選擇權,CALL,自營商,43273,43936,41688,46357,1585,-2422,75202,95712,64591,74676,10611,21036
2016/12/27,臺指選擇權,CALL,投信,0,0,0,0,0,0,380,50,380,106,0,-56
2016/12/27,臺指選擇權,CALL,外資及陸資,11521,28827,11765,31296,-244,-2469,57798,129679,32725,62452,25073,67227
2016/12/27,臺指選擇權,PUT,自營商,48241,64976,46492,64372,1749,604,89203,129900,62428,165130,26775,-35230
2016/12/27,臺指選擇權,PUT,投信,0,0,0,0,0,0,140,266,140,427,0,-161
2016/12/27,臺指選擇權,PUT,外資及陸資,14523,38092,11822,35286,2701,2806,87393,329700,39042,216956,48351,112744
2016/12/28,臺指選擇權,CALL,自營商,112239,187477,111792,171344,447,16134,52760,134776,51420,93848,1340,40928
2016/12/28,臺指選擇權,CALL,投信,0,0,0,0,0,0,380,90,380,192,0,-102
2016/12/28,臺指選擇權,CALL,外資及陸資,42087,107747,31976,90051,10111,17696,58724,178685,27257,80084,31467,98601
2016/12/28,臺指選擇權,PUT,自營商,95423,118859,116091,134279,-20668,-15420,56712,79330,49751,96125,6961,-16795
2016/12/28,臺指選擇權,PUT,投信,0,0,0,0,0,0,140,123,140,214,0,-91
2016/12/28,臺指選擇權,PUT,外資及陸資,36334,77993,28946,68499,7388,9494,88692,247747,38146,153588,50546,94159
2016/12/29,臺指選擇權,CALL,自營商,85497,111408,70813,124032,14684,-12624,75170,131887,59261,99745,15909,32142
2016/12/29,臺指選擇權,CALL,投信,0,0,0,0,0,0,380,61,380,142,0,-81
2016/12/29,臺指選擇權,CALL,外資及陸資,23930,67580,25295,74727,-1365,-7147,60373,163389,30278,76741,30095,86648
2016/12/29,臺指選擇權,PUT,自營商,88718,106125,76021,147135,12697,-41010,84832,105726,65248,168815,19584,-63089
2016/12/29,臺指選擇權,PUT,投信,0,0,0,0,0,0,140,158,140,273,0,-115
2016/12/29,臺指選擇權,PUT,外資及陸資,31751,68155,25636,74699,6115,-6544,98068,278262,41322,181926,56746,96336
2016/12/30,臺指選擇權,CALL,自營商,121218,220848,107406,200571,13812,20277,90672,198928,60986,151932,29686,46996
2016/12/30,臺指選擇權,CALL,投信,0,0,0,0,0,0,380,113,380,260,0,-147
2016/12/30,臺指選擇權,CALL,外資及陸資,42825,127822,37432,119383,5393,8439,65291,214665,29776,103717,35515,110948
2016/12/30,臺指選擇權,PUT,自營商,122659,157214,114502,138318,8157,18896,90669,86167,62936,95848,27733,-9681
2016/12/30,臺指選擇權,PUT,投信,0,0,0,0,0,0,140,98,140,168,0,-70
2016/12/30,臺指選擇權,PUT,外資及陸資,40977,87003,31891,79889,9086,7114,107098,223741,41285,135150,65813,88591
2017/1/3,臺指選擇權,CALL,自營商,80600,100635,76241,123473,4359,-22837,101038,203240,66965,185615,34073,17625
2017/1/3,臺指選擇權,CALL,投信,0,0,0,0,0,0,380,104,380,262,0,-158
2017/1/3,臺指選擇權,CALL,外資及陸資,28005,76052,27444,75916,561,136,67216,221276,31140,109121,36076,112155
2017/1/3,臺指選擇權,PUT,自營商,97098,117894,87488,99783,9610,18110,94874,80126,57472,74606,37402,5520
2017/1/3,臺指選擇權,PUT,投信,0,0,0,0,0,0,140,65,140,119,0,-54
2017/1/3,臺指選擇權,PUT,外資及陸資,29168,67045,30246,72772,-1078,-5728,107468,198158,42722,123757,64746,74401
2017/1/4,臺指選擇權,CALL,自營商,88519,125291,96893,132069,-8374,-6778,66660,170654,51366,104025,15294,66629
2017/1/4,臺指選擇權,CALL,投信,0,0,0,0,0,0,380,74,380,194,0,-120
2017/1/4,臺指選擇權,CALL,外資及陸資,26390,69895,24698,68083,1692,1812,65740,209984,30935,98284,34805,111700
2017/1/4,臺指選擇權,PUT,自營商,97414,118782,118770,128821,-21356,-10038,62589,74604,49311,75645,13278,-1041
2017/1/4,臺指選擇權,PUT,投信,0,0,0,0,0,0,140,49,140,95,0,-46
2017/1/4,臺指選擇權,PUT,外資及陸資,25061,49812,22967,54720,2094,-4907,100895,195937,43958,129099,56937,66838
2017/1/5,臺指選擇權,CALL,自營商,100211,166932,95588,201003,4623,-34071,80743,213700,60825,174561,19918,39139
2017/1/5,臺指選擇權,CALL,投信,0,0,0,0,0,0,380,123,380,319,0,-196
2017/1/5,臺指選擇權,CALL,外資及陸資,39906,125659,33380,109155,6526,16504,72133,271524,30792,124261,41341,147263
2017/1/5,臺指選擇權,PUT,自營商,126455,147199,124618,157024,1837,-9825,75834,65933,60681,73846,15153,-7913
2017/1/5,臺指選擇權,PUT,投信,0,0,0,0,0,0,140,22,140,40,0,-18
2017/1/5,臺指選擇權,PUT,外資及陸資,39923,85228,30660,78164,9263,7064,108908,153730,42732,91426,66176,62304
2017/1/6,臺指選擇權,CALL,自營商,60747,90841,52526,97572,8221,-6731,90701,229296,62470,199691,28231,29605
2017/1/6,臺指選擇權,CALL,投信,0,0,0,0,0,0,380,122,380,346,0,-224
2017/1/6,臺指選擇權,CALL,外資及陸資,22011,68086,19093,64666,2918,3420,75965,291293,31656,134032,44309,157261
2017/1/6,臺指選擇權,PUT,自營商,70319,74044,73166,81725,-2847,-7681,83122,63392,70800,76758,12322,-13366
2017/1/6,臺指選擇權,PUT,投信,0,0,0,0,0,0,140,15,140,25,0,-10
2017/1/6,臺指選擇權,PUT,外資及陸資,18775,48111,18173,45956,602,2155,111272,147219,44492,86779,66780,60440
2017/1/9,臺指選擇權,CALL,自營商,102854,149548,110405,192006,-7551,-42458,92219,202399,71592,198009,20627,4390
2017/1/9,臺指選擇權,CALL,投信,0,0,0,0,0,0,380,87,380,262,0,-175
2017/1/9,臺指選擇權,CALL,外資及陸資,40976,110447,38665,108379,2311,2067,79845,270415,33234,119310,46611,151105
2017/1/9,臺指選擇權,PUT,自營商,110240,143710,105725,141462,4515,2249,96272,92476,79432,112169,16840,-19693
2017/1/9,臺指選擇權,PUT,投信,0,0,0,0,0,0,140,15,140,25,0,-10
2017/1/9,臺指選擇權,PUT,外資及陸資,36643,88702,32833,80576,3810,8126,116083,166814,45493,96179,70590,70635
2017/1/10,臺指選擇權,CALL,自營商,63112,93402,59151,79999,3961,13403,94752,207557,70177,185804,24575,21753
2017/1/10,臺指選擇權,CALL,投信,0,0,0,0,0,0,380,58,380,215,0,-157
2017/1/10,臺指選擇權,CALL,外資及陸資,23341,59942,21000,56521,2341,3421,82327,268308,33348,115182,48979,153126
2017/1/10,臺指選擇權,PUT,自營商,71644,103916,79130,101899,-7486,2017,95489,89010,86191,108981,9298,-19971
2017/1/10,臺指選擇權,PUT,投信,0,0,0,0,0,0,140,11,140,18,0,-7
2017/1/10,臺指選擇權,PUT,外資及陸資,26261,63597,23721,63675,2540,-77,119744,169993,46604,99612,73140,70381
2017/1/11,臺指選擇權,CALL,自營商,105169,135048,125236,151739,-20067,-16691,62772,191241,63124,148212,-352,43029
2017/1/11,臺指選擇權,CALL,投信,0,0,0,0,0,0,380,51,380,187,0,-136
2017/1/11,臺指選擇權,CALL,外資及陸資,34496,78641,31840,77403,2656,1238,84246,268508,33858,113239,50388,155269
2017/1/11,臺指選擇權,PUT,自營商,128723,163875,127497,150185,1226,13690,69646,80058,62870,82691,6776,-2633
2017/1/11,臺指選擇權,PUT,投信,0,0,0,0,0,0,140,8,140,15,0,-7
2017/1/11,臺指選擇權,PUT,外資及陸資,35362,76632,30645,69548,4717,7084,122373,179441,46295,101741,76078,77700
2017/1/12,臺指選擇權,CALL,自營商,107965,226646,101883,229358,6082,-2712,78234,267653,72455,234763,5779,32890
2017/1/12,臺指選擇權,CALL,投信,0,0,0,0,0,0,380,97,380,370,0,-273
2017/1/12,臺指選擇權,CALL,外資及陸資,51568,174379,41014,146467,10554,27912,92429,365616,31479,147548,60950,218068
2017/1/12,臺指選擇權,PUT,自營商,101309,115949,105157,128500,-3848,-12551,78331,65487,75365,84138,2966,-18651
2017/1/12,臺指選擇權,PUT,投信,0,0,0,0,0,0,140,4,140,6,0,-2
2017/1/12,臺指選擇權,PUT,外資及陸資,43621,92684,32762,85178,10859,7507,133432,161316,46495,88281,86937,73035
2017/1/13,臺指選擇權,CALL,自營商,58026,84401,76824,133231,-18798,-48830,73370,208340,86386,206353,-13016,1987
2017/1/13,臺指選擇權,CALL,投信,0,0,0,0,0,0,380,47,380,215,0,-168
2017/1/13,臺指選擇權,CALL,外資及陸資,27921,70175,32059,82240,-4138,-12065,93564,322285,36793,135177,56771,187108
2017/1/13,臺指選擇權,PUT,自營商,87193,114911,67076,90253,20117,24657,104656,99847,81504,95969,23152,3878
2017/1/13,臺指選擇權,PUT,投信,0,0,0,0,0,0,140,4,140,5,0,-1
2017/1/13,臺指選擇權,PUT,外資及陸資,32358,80917,24138,72449,8220,8468,143941,196807,48785,111083,95156,85724
2017/1/16,臺指選擇權,CALL,自營商,102160,109906,113143,141844,-10983,-31938,78261,147285,102290,131420,-24029,15865
2017/1/16,臺指選擇權,CALL,投信,170,317,170,585,0,-269,550,305,550,595,0,-290
2017/1/16,臺指選擇權,CALL,外資及陸資,38830,91089,34218,78113,4612,12977,98567,254036,37175,84846,61392,169190
2017/1/16,臺指選擇權,PUT,自營商,101660,190577,104088,201025,-2428,-10448,110764,193982,90054,159931,20710,34051
2017/1/16,臺指選擇權,PUT,投信,170,238,170,346,0,-108,310,246,310,362,0,-116
2017/1/16,臺指選擇權,PUT,外資及陸資,54994,142257,45762,137976,9232,4282,155864,281636,51483,164237,104381,117399
2017/1/17,臺指選擇權,CALL,自營商,85328,148518,80022,163139,5306,-14621,85966,203220,104706,214118,-18740,-10898
2017/1/17,臺指選擇權,CALL,投信,0,0,0,0,0,0,550,384,550,743,0,-359
2017/1/17,臺指選擇權,CALL,外資及陸資,35055,101862,32603,100490,2452,1372,105221,319977,41389,129072,63832,190905
2017/1/17,臺指選擇權,PUT,自營商,89057,124093,96221,133984,-7164,-9891,120261,155353,106730,155958,13531,-605
2017/1/17,臺指選擇權,PUT,投信,0,0,0,0,0,0,310,188,310,274,0,-86
2017/1/17,臺指選擇權,PUT,外資及陸資,27881,71142,30993,92065,-3112,-20923,158125,241388,56821,165666,101304,75722
2017/1/18,臺指選擇權,CALL,自營商,119776,217671,136962,217062,-17186,609,55635,124643,50563,145642,5072,-20999
2017/1/18,臺指選擇權,CALL,投信,0,0,0,0,0,0,210,314,210,616,0,-302
2017/1/18,臺指選擇權,CALL,外資及陸資,34160,95177,27029,71787,7131,23390,80360,284565,21429,81274,58931,203291
2017/1/18,臺指選擇權,PUT,自營商,115075,166891,130690,170767,-15615,-3876,62932,142275,68062,162953,-5130,-20678
2017/1/18,臺指選擇權,PUT,投信,0,0,0,0,0,0,170,191,170,281,0,-90
2017/1/18,臺指選擇權,PUT,外資及陸資,35033,95075,22038,58425,12995,36650,88151,274520,39994,166943,48157,107577
2017/1/19,臺指選擇權,CALL,自營商,110184,427922,109920,397093,264,30829,95079,341775,89781,331402,5298,10373
2017/1/19,臺指選擇權,CALL,投信,0,0,0,0,0,0,210,314,210,591,0,-277
2017/1/19,臺指選擇權,CALL,外資及陸資,31858,116061,41465,155671,-9607,-39610,81189,276565,31862,117493,49327,159072
2017/1/19,臺指選擇權,PUT,自營商,138441,434568,122521,479072,15920,-44504,114550,355278,103789,426555,10761,-71277
2017/1/19,臺指選擇權,PUT,投信,0,0,0,0,0,0,170,191,170,293,0,-102
2017/1/19,臺指選擇權,PUT,外資及陸資,42659,165057,36951,140714,5708,24343,98863,327278,44981,192436,53882,134842
2017/1/20,臺指選擇權,CALL,自營商,61612,124805,49490,92839,12122,31966,104646,389270,87177,347432,17469,41838
2017/1/20,臺指選擇權,CALL,投信,0,0,0,0,0,0,210,332,210,668,0,-336
2017/1/20,臺指選擇權,CALL,外資及陸資,17915,62826,19253,67346,-1338,-4520,82209,293566,34191,134686,48018,158880
2017/1/20,臺指選擇權,PUT,自營商,100971,119433,83532,144955,17439,-25522,145865,315185,117692,406670,28173,-91485
2017/1/20,臺指選擇權,PUT,投信,0,0,0,0,0,0,170,166,170,255,0,-89
2017/1/20,臺指選擇權,PUT,外資及陸資,34157,68286,21505,67660,12652,627,114040,315512,47517,187553,66523,127959
2017/1/23,臺指選擇權,CALL,自營商,92692,238272,78238,200731,14454,37541,126701,540737,94810,461389,31891,79348
2017/1/23,臺指選擇權,CALL,投信,0,0,0,0,0,0,210,491,210,908,0,-417
2017/1/23,臺指選擇權,CALL,外資及陸資,34065,124346,32618,120913,1447,3433,86962,372038,37519,189113,49443,182925
2017/1/23,臺指選擇權,PUT,自營商,116421,143903,114432,173449,1989,-29546,154216,210234,124050,303925,30166,-93691
2017/1/23,臺指選擇權,PUT,投信,0,0,0,0,0,0,170,83,170,136,0,-53
2017/1/23,臺指選擇權,PUT,外資及陸資,39780,88345,32183,82036,7597,6309,125110,254817,50968,144596,74142,110221
2017/1/24,臺指選擇權,CALL,自營商,101028,225961,91322,209263,9706,16698,138664,588939,97085,491648,41579,97291
2017/1/24,臺指選擇權,CALL,投信,0,0,0,0,0,0,210,569,210,1028,0,-459
2017/1/24,臺指選擇權,CALL,外資及陸資,25758,81299,21990,80729,3768,570,93628,402989,40424,210907,53204,192082
2017/1/24,臺指選擇權,PUT,自營商,124451,170147,128465,176581,-4014,-6434,157014,176522,130864,257246,26150,-80724
2017/1/24,臺指選擇權,PUT,投信,3700,6882,0,0,3700,6882,3870,6098,170,83,3700,6015
2017/1/24,臺指選擇權,PUT,外資及陸資,29236,50889,18637,47778,10599,3111,137304,228341,52564,123725,84740,104616
2017/2/2,臺指選擇權,CALL,自營商,200396,292990,247373,368238,-46977,-75247,108671,376450,96675,320561,11996,55889
2017/2/2,臺指選擇權,CALL,投信,0,0,0,0,0,0,210,232,210,563,0,-331
2017/2/2,臺指選擇權,CALL,外資及陸資,45990,129193,42155,119829,3835,9364,93331,302885,37817,135206,55514,167679
2017/2/2,臺指選擇權,PUT,自營商,226911,299507,240828,290519,-13917,8988,102553,244289,119199,333680,-16646,-89391
2017/2/2,臺指選擇權,PUT,投信,0,0,3700,3321,-3700,-3321,170,48,170,78,0,-30
2017/2/2,臺指選擇權,PUT,外資及陸資,46563,113792,38465,99605,8098,14187,119358,264949,49591,137626,69767,127323
2017/2/3,臺指選擇權,CALL,自營商,89197,141913,89212,162329,-15,-20416,117591,475987,105626,435447,11965,40540
2017/2/3,臺指選擇權,CALL,投信,0,0,0,0,0,0,210,369,210,820,0,-451
2017/2/3,臺指選擇權,CALL,外資及陸資,29942,92037,29529,86990,413,5047,94733,362376,38737,169865,55996,192511
2017/2/3,臺指選擇權,PUT,自營商,120537,133092,102816,144401,17721,-11309,128745,173231,127742,256901,1003,-83670
2017/2/3,臺指選擇權,PUT,投信,0,0,0,0,0,0,170,25,170,38,0,-13
2017/2/3,臺指選擇權,PUT,外資及陸資,33603,100001,27012,86604,6591,13397,127977,240982,51652,119047,76325,121935
2017/2/6,臺指選擇權,CALL,自營商,116838,282098,105177,204287,11661,77811,130337,640436,106660,548155,23677,92281
2017/2/6,臺指選擇權,CALL,投信,0,0,0,0,0,0,210,541,210,1119,0,-578
2017/2/6,臺指選擇權,CALL,外資及陸資,51214,154774,38299,123171,12915,31603,105821,448880,36888,203281,68933,245599
2017/2/6,臺指選擇權,PUT,自營商,172353,187070,179290,195478,-6937,-8408,147809,143526,153782,211651,-5973,-68125
2017/2/6,臺指選擇權,PUT,投信,0,0,0,0,0,0,170,13,170,20,0,-7
2017/2/6,臺指選擇權,PUT,外資及陸資,54688,151232,37982,104048,16706,47184,147118,254952,54090,108290,93028,146662
2017/2/7,臺指選擇權,CALL,自營商,70775,131209,77907,138485,-7132,-7276,130995,684050,114439,604567,16556,79483
2017/2/7,臺指選擇權,CALL,投信,0,0,0,0,0,0,210,575,210,1204,0,-629
2017/2/7,臺指選擇權,CALL,外資及陸資,24485,63051,22681,66945,1804,-3894,109141,464408,38465,219350,70676,245058
2017/2/7,臺指選擇權,PUT,自營商,99448,100009,100498,121217,-1050,-21209,156888,128490,164042,216720,-7154,-88230
2017/2/7,臺指選擇權,PUT,投信,0,0,0,0,0,0,170,9,170,15,0,-6
2017/2/7,臺指選擇權,PUT,外資及陸資,28471,104288,20605,74563,7866,29725,157342,302942,56705,137280,100637,165662
2017/2/8,臺指選擇權,CALL,自營商,133338,154723,138858,169228,-5520,-14505,115957,602149,91402,513216,24555,88933
2017/2/8,臺指選擇權,CALL,投信,0,0,0,0,0,0,210,506,210,1126,0,-620
2017/2/8,臺指選擇權,CALL,外資及陸資,46094,104384,39667,94507,6427,9877,114694,450231,37016,206659,77678,243572
2017/2/8,臺指選擇權,PUT,自營商,154345,165502,167837,185340,-13492,-19839,114038,108625,136577,214083,-22539,-105458
2017/2/8,臺指選擇權,PUT,投信,0,0,0,0,0,0,170,9,170,14,0,-5
2017/2/8,臺指選擇權,PUT,外資及陸資,47862,121523,42768,104033,5094,17490,163463,337974,58196,157047,105267,180927
2017/2/9,臺指選擇權,CALL,自營商,88319,152943,93747,181682,-5428,-28739,114466,722556,95292,651197,19174,71359
2017/2/9,臺指選擇權,CALL,投信,0,0,0,0,0,0,210,781,210,1555,0,-774
2017/2/9,臺指選擇權,CALL,外資及陸資,36927,106344,32167,91288,4760,15056,120167,528219,37730,247653,82437,280566
2017/2/9,臺指選擇權,PUT,自營商,105069,121414,104359,132740,710,-11326,125460,81958,147306,178238,-21846,-96280
2017/2/9,臺指選擇權,PUT,投信,0,0,0,0,0,0,170,4,170,4,0,0
2017/2/9,臺指選擇權,PUT,外資及陸資,39894,77775,28470,67656,11424,10119,175678,287393,58999,131151,116679,156242
2017/2/10,臺指選擇權,CALL,自營商,172734,556400,157772,383831,14962,172569,130448,1061062,96330,807566,34118,253496
2017/2/10,臺指選擇權,CALL,投信,0,0,0,0,0,0,210,1387,210,2237,0,-850
2017/2/10,臺指選擇權,CALL,外資及陸資,63299,222878,58403,223681,4896,-803,124689,726891,37333,336628,87356,390263
2017/2/10,臺指選擇權,PUT,自營商,148160,169239,176575,208330,-28415,-39091,122420,66975,172673,170363,-50253,-103388
2017/2/10,臺指選擇權,PUT,投信,0,0,0,0,0,0,170,3,170,4,0,-1
2017/2/10,臺指選擇權,PUT,外資及陸資,44457,133923,39081,105816,5376,28107,187044,292245,64979,134621,122065,157624
2017/2/13,臺指選擇權,CALL,自營商,66384,124510,78128,174866,-11744,-50356,130927,1191107,108571,947418,22356,243689
2017/2/13,臺指選擇權,CALL,投信,0,0,0,0,0,0,210,1779,210,2620,0,-841
2017/2/13,臺指選擇權,CALL,外資及陸資,37731,103117,33017,105295,4714,-2178,128720,841559,36677,386300,92043,455259
2017/2/13,臺指選擇權,PUT,自營商,94486,99788,92205,96494,2281,3293,126749,66061,174687,144446,-47938,-78385
2017/2/13,臺指選擇權,PUT,投信,0,0,0,0,0,0,170,3,170,3,0,0
2017/2/13,臺指選擇權,PUT,外資及陸資,26806,57281,27364,53231,-558,4050,189542,260116,68038,118423,121504,141693
2017/2/14,臺指選擇權,CALL,自營商,155277,354987,151759,317087,3518,37901,132490,1229575,106600,951326,25890,278249
2017/2/14,臺指選擇權,CALL,投信,0,0,0,0,0,0,210,1796,210,2646,0,-850
2017/2/14,臺指選擇權,CALL,外資及陸資,61368,181038,60444,196064,924,-15026,130301,856646,37303,397228,92998,459418
2017/2/14,臺指選擇權,PUT,自營商,138639,161242,156290,174485,-17651,-13243,131744,87559,197312,177603,-65568,-90044
2017/2/14,臺指選擇權,PUT,投信,0,0,0,0,0,0,170,3,170,3,0,0
2017/2/14,臺指選擇權,PUT,外資及陸資,44820,96126,46960,107259,-2140,-11132,192689,265963,73313,132669,119376,133294
2017/2/15,臺指選擇權,CALL,自營商,162823,337849,175054,421683,-12231,-83834,66360,392203,62338,320088,4022,72115
2017/2/15,臺指選擇權,CALL,投信,170,332,170,578,0,-247,170,357,170,638,0,-281
2017/2/15,臺指選擇權,CALL,外資及陸資,45115,114691,39073,129837,6042,-15146,99991,876847,22069,238391,77922,638456
2017/2/15,臺指選擇權,PUT,自營商,139381,147483,181433,202063,-42052,-54580,65096,65434,101843,157086,-36747,-91652
2017/2/15,臺指選擇權,PUT,投信,170,210,170,307,0,-98,170,179,170,285,0,-106
2017/2/15,臺指選擇權,PUT,外資及陸資,26907,59097,29355,66030,-2448,-6933,112133,219300,48192,115285,63941,104015
2017/2/16,臺指選擇權,CALL,自營商,119641,223068,119463,280266,178,-57198,84717,369309,80557,349781,4160,19528
2017/2/16,臺指選擇權,CALL,投信,0,0,0,0,0,0,170,323,170,570,0,-247
2017/2/16,臺指選擇權,CALL,外資及陸資,40501,131945,47923,181515,-7422,-49570,99323,801097,28829,243162,70494,557935
2017/2/16,臺指選擇權,PUT,自營商,150358,224380,121839,215508,28519,8873,102293,105384,110564,205905,-8271,-100521
2017/2/16,臺指選擇權,PUT,投信,0,0,0,0,0,0,170,200,170,319,0,-119
2017/2/16,臺指選擇權,PUT,外資及陸資,51414,135263,44084,136211,7330,-947,125237,250478,53949,150201,71288,100277
2017/2/17,臺指選擇權,CALL,自營商,58893,109563,54846,103010,4047,6553,91254,373365,83021,347420,8233,25945
2017/2/17,臺指選擇權,CALL,投信,0,0,0,0,0,0,170,272,170,510,0,-238
2017/2/17,臺指選擇權,CALL,外資及陸資,18721,57852,21468,72610,-2747,-14759,99160,771613,31397,244551,67763,527062
2017/2/17,臺指選擇權,PUT,自營商,73693,113414,70258,120631,3435,-7217,111854,124684,116656,230389,-4802,-105705
2017/2/17,臺指選擇權,PUT,投信,0,0,0,0,0,0,170,187,170,293,0,-106
2017/2/17,臺指選擇權,PUT,外資及陸資,25614,69740,24266,70624,1348,-884,129688,255839,57114,157377,72574,98462
2017/2/18,臺指選擇權,CALL,自營商,35532,40143,32578,61495,2954,-21352,100001,383554,88671,378448,11330,5106
2017/2/18,臺指選擇權,CALL,投信,0,0,0,0,0,0,170,298,170,536,0,-238
2017/2/18,臺指選擇權,CALL,外資及陸資,3992,13059,3813,12843,179,216,99544,802345,31580,254905,67964,547440
2017/2/18,臺指選擇權,PUT,自營商,50530,61245,39737,44903,10793,16342,119211,113901,113320,181567,5891,-67666
2017/2/18,臺指選擇權,PUT,投信,0,0,0,0,0,0,170,136,170,230,0,-94
2017/2/18,臺指選擇權,PUT,外資及陸資,5209,13062,4012,9966,1197,3096,130732,228261,56974,135010,73758,93251
2017/2/20,臺指選擇權,CALL,自營商,105291,147989,94865,142656,10426,5333,111672,360755,89916,345801,21756,14954
2017/2/20,臺指選擇權,CALL,投信,0,0,0,0,0,0,170,230,170,434,0,-204
2017/2/20,臺指選擇權,CALL,外資及陸資,32371,86062,30648,87692,1723,-1630,101382,743998,31695,235202,69687,508796
2017/2/20,臺指選擇權,PUT,自營商,99281,130857,92725,130856,6556,1,127735,132126,115288,202259,12447,-70133
2017/2/20,臺指選擇權,PUT,投信,0,0,0,0,0,0,170,140,170,242,0,-102
2017/2/20,臺指選擇權,PUT,外資及陸資,31338,80067,29038,77115,2300,2952,133184,245261,57126,145201,76058,100060
2017/2/21,臺指選擇權,CALL,自營商,95365,112625,98338,130936,-2973,-18311,121108,362625,102330,366698,18778,-4073
2017/2/21,臺指選擇權,CALL,投信,0,0,0,0,0,0,170,208,170,408,0,-200
2017/2/21,臺指選擇權,CALL,外資及陸資,29193,65056,27759,70299,1434,-5243,103916,738570,32833,237683,71083,500887
2017/2/21,臺指選擇權,PUT,自營商,110664,157505,101484,155518,9180,1987,141062,152147,119440,215431,21622,-63284
2017/2/21,臺指選擇權,PUT,投信,0,0,0,0,0,0,170,119,170,200,0,-81
2017/2/21,臺指選擇權,PUT,外資及陸資,37196,124569,34237,91698,2959,32871,140695,285953,61642,155761,79053,130192
2017/2/22,臺指選擇權,CALL,自營商,126917,218064,152812,212164,-25895,5900,84055,365442,90641,357396,-6586,8046
2017/2/22,臺指選擇權,CALL,投信,0,0,0,0,0,0,170,208,170,421,0,-213
2017/2/22,臺指選擇權,CALL,外資及陸資,47857,120651,46445,127900,1412,-7249,101275,759292,31635,248444,69640,510848
2017/2/22,臺指選擇權,PUT,自營商,140368,178434,153266,218216,-12898,-39782,85779,125491,102886,215726,-17107,-90235
2017/2/22,臺指選擇權,PUT,投信,0,0,0,0,0,0,170,106,170,179,0,-73
2017/2/22,臺指選擇權,PUT,外資及陸資,52400,139992,49166,119124,3234,20868,142174,329069,65692,178831,76482,150238
2017/2/23,臺指選擇權,CALL,自營商,92394,141742,76257,129141,16137,12602,102207,349790,92658,335339,9549,14451
2017/2/23,臺指選擇權,CALL,投信,0,0,0,0,0,0,170,170,170,357,0,-187
2017/2/23,臺指選擇權,CALL,外資及陸資,33709,97971,30736,90721,2973,7250,104139,732485,31528,236787,72611,495698
2017/2/23,臺指選擇權,PUT,自營商,102329,116442,85270,140201,17059,-23759,118010,136569,118107,249809,-97,-113240
2017/2/23,臺指選擇權,PUT,投信,0,0,0,0,0,0,170,94,170,170,0,-76
2017/2/23,臺指選擇權,PUT,外資及陸資,41808,94598,34591,89219,7217,5379,152259,330588,68560,177113,83699,153475
2017/2/24,臺指選擇權,CALL,自營商,86625,109637,76169,115671,10456,-6034,115382,333129,95386,327373,19996,5756
2017/2/24,臺指選擇權,CALL,投信,0,0,0,0,0,0,170,166,170,336,0,-170
2017/2/24,臺指選擇權,CALL,外資及陸資,17962,50642,17209,50453,753,189,104716,712207,31353,230217,73363,481990
2017/2/24,臺指選擇權,PUT,自營商,112474,128726,81300,119657,31174,9069,145336,145189,114263,256184,31073,-110995
2017/2/24,臺指選擇權,PUT,投信,0,0,0,0,0,0,170,89,170,174,0,-85
2017/2/24,臺指選擇權,PUT,外資及陸資,37954,71828,33829,64662,4125,7165,169517,365197,81712,198840,87805,166357
2017/3/1,臺指選擇權,CALL,自營商,151810,193239,172399,227094,-20589,-33856,84690,248232,99737,250746,-15047,-2514
2017/3/1,臺指選擇權,CALL,投信,0,0,0,0,0,0,170,63,170,149,0,-86
2017/3/1,臺指選擇權,CALL,外資及陸資,54479,113922,50607,113333,3872,589,103081,559076,31454,181983,71627,377093
2017/3/1,臺指選擇權,PUT,自營商,169407,254204,147221,197123,22186,57081,100331,192108,106047,272957,-5716,-80849
2017/3/1,臺指選擇權,PUT,投信,0,0,0,0,0,0,170,119,170,238,0,-119
2017/3/1,臺指選擇權,PUT,外資及陸資,61380,136853,52881,132164,8499,4689,170406,458300,84501,259540,85905,198760
2017/3/2,臺指選擇權,CALL,自營商,159794,221348,153122,239450,6672,-18102,103271,259505,111612,272899,-8341,-13394
2017/3/2,臺指選擇權,CALL,投信,0,0,0,0,0,0,170,60,170,140,0,-80
2017/3/2,臺指選擇權,CALL,外資及陸資,51349,138792,48683,135481,2666,3310,106141,565410,31816,184885,74325,380525
2017/3/2,臺指選擇權,PUT,自營商,172803,224569,151020,247086,21783,-22518,128909,192918,112877,290183,16032,-97265
2017/3/2,臺指選擇權,PUT,投信,0,0,0,0,0,0,170,85,170,187,0,-102
2017/3/2,臺指選擇權,PUT,外資及陸資,55364,150537,47799,141328,7565,9209,181345,452919,87856,248205,93489,204714
2017/3/3,臺指選擇權,CALL,自營商,135000,158723,133731,171732,1269,-13009,117425,211677,124543,223559,-7118,-11882
2017/3/3,臺指選擇權,CALL,投信,0,0,0,0,0,0,170,20,170,49,0,-29
2017/3/3,臺指選擇權,CALL,外資及陸資,37328,98699,32636,85609,4692,13090,110830,464321,31816,146817,79014,317504
2017/3/3,臺指選擇權,PUT,自營商,111882,238821,106055,196618,5827,42203,140493,278542,118701,348976,21792,-70434
2017/3/3,臺指選擇權,PUT,投信,0,0,0,0,0,0,170,115,170,251,0,-136
2017/3/3,臺指選擇權,PUT,外資及陸資,42487,132987,37205,122091,5282,10896,189616,545703,90852,307350,98764,238353
2017/3/6,臺指選擇權,CALL,自營商,105708,146724,95571,144051,10137,2673,129165,255885,126009,284531,3156,-28646
2017/3/6,臺指選擇權,CALL,投信,0,0,0,0,0,0,170,20,170,54,0,-34
2017/3/6,臺指選擇權,CALL,外資及陸資,39926,90074,31779,79738,8147,10336,120418,526269,33194,165708,87224,360561
2017/3/6,臺指選擇權,PUT,自營商,104040,124362,122697,186382,-18657,-62020,138525,193941,135439,292628,3086,-98687
2017/3/6,臺指選擇權,PUT,投信,0,0,0,0,0,0,170,54,170,119,0,-65
2017/3/6,臺指選擇權,PUT,外資及陸資,36910,95441,39114,100940,-2204,-5499,193446,451385,96931,246612,96515,204773
2017/3/7,臺指選擇權,CALL,自營商,98658,158863,94683,124821,3975,34041,127133,297573,119958,300157,7175,-2584
2017/3/7,臺指選擇權,CALL,投信,0,0,0,0,0,0,170,14,170,53,0,-39
2017/3/7,臺指選擇權,CALL,外資及陸資,30680,81017,29383,79698,1297,1319,122278,583134,33786,184192,88492,398942
2017/3/7,臺指選擇權,PUT,自營商,119737,123525,117129,98237,2608,25288,143082,161777,137441,206403,5641,-44626
2017/3/7,臺指選擇權,PUT,投信,0,0,0,0,0,0,170,24,170,54,0,-30
2017/3/7,臺指選擇權,PUT,外資及陸資,31717,63838,25413,54652,6304,9186,201458,359025,98605,181849,102853,177176
2017/3/8,臺指選擇權,CALL,自營商,144553,243254,144469,218948,84,24306,86257,257299,99917,258324,-13660,-1025
2017/3/8,臺指選擇權,CALL,投信,0,0,0,0,0,0,170,14,170,48,0,-34
2017/3/8,臺指選擇權,CALL,外資及陸資,43530,103805,40120,102401,3410,1404,124684,603934,33772,191895,90912,412039
2017/3/8,臺指選擇權,PUT,自營商,145748,144195,160649,146050,-14901,-1855,97411,134918,113265,176832,-15854,-41914
2017/3/8,臺指選擇權,PUT,投信,0,0,0,0,0,0,170,20,170,35,0,-15
2017/3/8,臺指選擇權,PUT,外資及陸資,41844,79302,41349,71175,495,8126,207637,325602,107525,160487,100112,165115
2017/3/9,臺指選擇權,CALL,自營商,123771,141116,132638,192875,-8867,-51758,86225,187573,108820,214346,-22595,-26773
2017/3/9,臺指選擇權,CALL,投信,0,0,0,0,0,0,170,3,170,8,0,-5
2017/3/9,臺指選擇權,CALL,外資及陸資,38054,93515,39292,99792,-1238,-6277,125318,441334,35671,147085,89647,294249
2017/3/9,臺指選擇權,PUT,自營商,138997,214100,126900,221867,12097,-7767,107341,207816,111063,261316,-3722,-53500
2017/3/9,臺指選擇權,PUT,投信,0,0,0,0,0,0,170,30,170,94,0,-64
2017/3/9,臺指選擇權,PUT,外資及陸資,60825,143683,40655,123756,20170,19926,228242,481041,107926,241328,120316,239713
2017/3/10,臺指選擇權,CALL,自營商,146693,192857,144468,163501,2225,29355,90323,190655,110609,171187,-20286,19468
2017/3/10,臺指選擇權,CALL,投信,0,0,0,0,0,0,170,1,170,2,0,-1
2017/3/10,臺指選擇權,CALL,外資及陸資,51960,117890,44266,108346,7694,9544,132456,401194,35060,130632,97396,270562
2017/3/10,臺指選擇權,PUT,自營商,145015,246593,147107,238487,-2092,8105,109914,211343,115724,257048,-5810,-45705
2017/3/10,臺指選擇權,PUT,投信,0,0,0,0,0,0,170,18,170,68,0,-50
2017/3/10,臺指選擇權,PUT,外資及陸資,87141,187014,51587,168355,35554,18660,248643,499701,92768,244057,155875,255644
2017/3/13,臺指選擇權,CALL,自營商,98031,166605,85768,141704,12263,24901,101124,256777,109126,209629,-8002,47148
2017/3/13,臺指選擇權,CALL,投信,0,0,0,0,0,0,170,1,170,1,0,0
2017/3/13,臺指選擇權,CALL,外資及陸資,36767,95492,31474,89658,5293,5834,137276,495133,34562,157756,102714,337377
2017/3/13,臺指選擇權,PUT,自營商,105761,123830,122945,125304,-17184,-1473,107839,156363,130918,184664,-23079,-28301
2017/3/13,臺指選擇權,PUT,投信,0,0,0,0,0,0,170,9,170,19,0,-10
2017/3/13,臺指選擇權,PUT,外資及陸資,34417,70231,31526,67552,2891,2678,248446,363074,89698,167296,158748,195778
2017/3/14,臺指選擇權,CALL,自營商,114379,203468,121484,244252,-7105,-40784,96642,294469,111661,267695,-15019,26774
2017/3/14,臺指選擇權,CALL,投信,170,244,170,449,0,-205,340,231,340,445,0,-214
2017/3/14,臺指選擇權,CALL,外資及陸資,35456,96269,28400,86049,7056,10220,144636,621607,34776,189522,109860,432085
2017/3/14,臺指選擇權,PUT,自營商,120423,116824,127291,115104,-6868,1720,103450,128603,133379,152408,-29929,-23805
2017/3/14,臺指選擇權,PUT,投信,170,263,170,382,0,-120,340,260,340,400,0,-140
2017/3/14,臺指選擇權,PUT,外資及陸資,23397,42743,22378,42132,1019,611,249101,298365,89385,133281,159716,165084
2017/3/15,臺指選擇權,CALL,自營商,111307,176378,133538,188848,-22231,-12471,55863,201798,42992,117018,12871,84780
2017/3/15,臺指選擇權,CALL,投信,0,0,0,0,0,0,170,221,170,412,0,-191
2017/3/15,臺指選擇權,CALL,外資及陸資,26797,59929,29056,65015,-2259,-5086,77271,302098,17811,112001,59460,190097
2017/3/15,臺指選擇權,PUT,自營商,122522,143940,142902,181691,-20380,-37751,50823,108040,65448,160570,-14625,-52530
2017/3/15,臺指選擇權,PUT,投信,0,0,0,0,0,0,170,268,170,412,0,-144
2017/3/15,臺指選擇權,PUT,外資及陸資,28642,55200,26681,53058,1961,2142,129630,306469,36556,138901,93074,167568
2017/3/16,臺指選擇權,CALL,自營商,92803,184060,87769,186518,5034,-2457,68776,308904,50905,192249,17871,116655
2017/3/16,臺指選擇權,CALL,投信,0,0,0,0,0,0,170,425,170,748,0,-323
2017/3/16,臺指選擇權,CALL,外資及陸資,42278,135935,34557,126525,7721,9410,86512,424317,19274,154422,67238,269895
2017/3/16,臺指選擇權,PUT,自營商,136120,159476,128482,175114,7638,-15638,75201,94903,82174,130410,-6973,-35507
2017/3/16,臺指選擇權,PUT,投信,0,0,0,0,0,0,170,123,170,196,0,-73
2017/3/16,臺指選擇權,PUT,外資及陸資,41567,95435,35264,87570,6303,7865,141178,210497,41786,95041,99392,115456
2017/3/17,臺指選擇權,CALL,自營商,79859,169080,85071,180409,-5212,-11329,73732,355177,61017,232674,12715,122503
2017/3/17,臺指選擇權,CALL,投信,0,0,0,0,0,0,170,536,170,884,0,-348
2017/3/17,臺指選擇權,CALL,外資及陸資,23326,85562,21839,82165,1487,3397,89583,483769,20813,178980,68770,304789
2017/3/17,臺指選擇權,PUT,自營商,109161,143549,92345,110256,16816,33294,85489,101050,75627,83969,9862,17081
2017/3/17,臺指選擇權,PUT,投信,0,0,0,0,0,0,170,83,170,132,0,-49
2017/3/17,臺指選擇權,PUT,外資及陸資,21882,51630,20424,48166,1458,3464,144598,173529,43787,77753,100811,95776
2017/3/20,臺指選擇權,CALL,自營商,90221,166266,95145,186733,-4924,-20467,74069,338446,66210,239232,7859,99214
2017/3/20,臺指選擇權,CALL,投信,0,0,0,0,0,0,170,536,170,876,0,-340
2017/3/20,臺指選擇權,CALL,外資及陸資,28095,90371,27420,92780,675,-2409,91238,487554,21837,184730,69401,302824
2017/3/20,臺指選擇權,PUT,自營商,109834,142297,102432,120153,7402,22144,98972,121273,81682,85585,17290,35688
2017/3/20,臺指選擇權,PUT,投信,0,0,0,0,0,0,170,77,170,111,0,-34
2017/3/20,臺指選擇權,PUT,外資及陸資,23626,58233,23604,60335,22,-2103,145781,164815,44926,77639,100855,87176
2017/3/21,臺指選擇權,CALL,自營商,148168,258371,128555,270771,19613,-12399,95758,416043,68154,309682,27604,106361
2017/3/21,臺指選擇權,CALL,投信,0,0,0,0,0,0,170,740,170,1190,0,-450
2017/3/21,臺指選擇權,CALL,外資及陸資,39459,137835,32500,118681,6959,19153,97718,595346,21267,212177,76451,383169
2017/3/21,臺指選擇權,PUT,自營商,151251,176335,162625,177231,-11374,-896,103184,114644,97281,81861,5903,32783
2017/3/21,臺指選擇權,PUT,投信,0,0,0,0,0,0,170,52,170,79,0,-27
2017/3/21,臺指選擇權,PUT,外資及陸資,25522,54372,25828,52343,-306,2029,151871,141941,51371,67620,100500,74321
2017/3/22,臺指選擇權,CALL,自營商,169968,234094,199016,264978,-29048,-30885,63383,283343,65614,218231,-2231,65112
2017/3/22,臺指選擇權,CALL,投信,0,0,0,0,0,0,170,510,170,884,0,-374
2017/3/22,臺指選擇權,CALL,外資及陸資,36473,91220,32524,86825,3949,4395,99647,494204,19913,172890,79734,321314
2017/3/22,臺指選擇權,PUT,自營商,210599,341358,213439,297910,-2840,43447,74697,162911,68013,91667,6684,71244
2017/3/22,臺指選擇權,PUT,投信,0,0,0,0,0,0,170,82,170,132,0,-50
2017/3/22,臺指選擇權,PUT,外資及陸資,47801,122041,45831,111122,1970,10918,156421,201837,55251,97138,101170,104699
2017/3/23,臺指選擇權,CALL,自營商,104545,197277,95845,206702,8700,-9425,80005,294673,73480,234694,6525,59979
2017/3/23,臺指選擇權,CALL,投信,0,0,0,0,0,0,170,527,170,918,0,-391
2017/3/23,臺指選擇權,CALL,外資及陸資,16704,62003,12924,50939,3780,11064,103585,517454,20031,176624,83554,340830
2017/3/23,臺指選擇權,PUT,自營商,142755,177364,120833,180836,21922,-3473,105473,172652,76862,103561,28611,69091
2017/3/23,臺指選擇權,PUT,投信,0,0,0,0,0,0,170,69,170,106,0,-37
2017/3/23,臺指選擇權,PUT,外資及陸資,15340,44203,15052,41551,288,2652,159380,189860,57921,92358,101459,97502
2017/3/24,臺指選擇權,CALL,自營商,78841,157295,82406,151342,-3565,5953,80564,291790,77585,224014,2979,67776
2017/3/24,臺指選擇權,CALL,投信,0,0,0,0,0,0,170,510,170,884,0,-374
2017/3/24,臺指選擇權,CALL,外資及陸資,25368,77650,25000,75007,368,2643,104939,511224,21016,174856,83923,336368
2017/3/24,臺指選擇權,PUT,自營商,104831,152363,100429,169511,4402,-17148,117812,180185,84813,124497,32999,55688
2017/3/24,臺指選擇權,PUT,投信,0,0,0,0,0,0,170,70,170,111,0,-41
2017/3/24,臺指選擇權,PUT,外資及陸資,31111,89352,27039,77892,4072,11460,165993,215260,60484,101054,105509,114206
2017/3/27,臺指選擇權,CALL,自營商,122995,193889,106830,160224,16165,33665,95530,281323,76267,188570,19263,92753
2017/3/27,臺指選擇權,CALL,投信,0,0,0,0,0,0,170,391,170,723,0,-332
2017/3/27,臺指選擇權,CALL,外資及陸資,29926,82346,27385,81360,2541,985,108061,458367,21580,162608,86481,295759
2017/3/27,臺指選擇權,PUT,自營商,133623,156983,125119,195321,8504,-38339,139319,198716,97851,179939,41468,18777
2017/3/27,臺指選擇權,PUT,投信,0,0,0,0,0,0,170,89,170,140,0,-51
2017/3/27,臺指選擇權,PUT,外資及陸資,38410,90809,30564,88800,7846,2008,175593,251738,62198,120233,113395,131505
2017/3/28,臺指選擇權,CALL,自營商,173080,212572,186252,246721,-13172,-34148,98346,294302,92305,220472,6041,73830
2017/3/28,臺指選擇權,CALL,投信,0,0,0,0,0,0,170,417,170,757,0,-340
2017/3/28,臺指選擇權,CALL,外資及陸資,49603,123980,45877,122766,3726,1215,113174,488512,22974,176090,90200,312422
2017/3/28,臺指選擇權,PUT,自營商,193902,280462,174340,263074,19562,17388,155644,188204,94620,147729,61024,40475
2017/3/28,臺指選擇權,PUT,投信,0,0,0,0,0,0,170,56,170,98,0,-42
2017/3/28,臺指選擇權,PUT,外資及陸資,46664,131601,46389,133947,275,-2345,178427,227664,64787,113630,113640,114034
2017/3/29,臺指選擇權,CALL,自營商,145135,154698,169284,180137,-24149,-25439,70682,266085,85509,213234,-14827,52851
2017/3/29,臺指選擇權,CALL,投信,0,0,0,0,0,0,170,340,170,646,0,-306
2017/3/29,臺指選擇權,CALL,外資及陸資,33334,77145,37053,82037,-3719,-4893,111409,455094,24708,171039,86701,284055
2017/3/29,臺指選擇權,PUT,自營商,168282,256280,169711,266010,-1429,-9730,93557,194038,86173,162320,7384,31718
2017/3/29,臺指選擇權,PUT,投信,0,0,0,0,0,0,170,63,170,102,0,-39
2017/3/29,臺指選擇權,PUT,外資及陸資,43826,107692,44154,111307,-328,-3616,174866,248752,67298,130644,107568,118108
2017/3/30,臺指選擇權,CALL,自營商,73646,110773,62930,100555,10716,10218,83535,256557,87671,195225,-4136,61332
2017/3/30,臺指選擇權,CALL,投信,0,0,0,0,0,0,170,285,170,561,0,-276
2017/3/30,臺指選擇權,CALL,外資及陸資,23486,66905,25907,76580,-2421,-9675,111124,432965,26815,169601,84309,263364
2017/3/30,臺指選擇權,PUT,自營商,112510,131428,87622,148986,24888,-17558,128467,203713,96253,188714,32214,14999
2017/3/30,臺指選擇權,PUT,投信,0,0,0,0,0,0,170,55,170,89,0,-34
2017/3/30,臺指選擇權,PUT,外資及陸資,33570,70568,30286,78551,3284,-7983,185453,254030,74603,142753,110850,111277
2017/3/31,臺指選擇權,CALL,自營商,89261,99820,78043,100471,11218,-652,95194,226890,88086,170254,7108,56636
2017/3/31,臺指選擇權,CALL,投信,0,0,0,0,0,0,170,213,170,434,0,-221
2017/3/31,臺指選擇權,CALL,外資及陸資,21922,53677,25554,61906,-3632,-8229,108922,390136,28243,154590,80679,235546
2017/3/31,臺指選擇權,PUT,自營商,109548,139470,100460,148734,9088,-9263,140761,213416,99463,217352,41298,-3936
2017/3/31,臺指選擇權,PUT,投信,0,0,0,0,0,0,170,57,170,98,0,-41
2017/3/31,臺指選擇權,PUT,外資及陸資,37645,82780,24997,68876,12648,13904,197943,282872,74441,151774,123502,131098
2017/4/5,臺指選擇權,CALL,自營商,161799,268519,152015,246915,9784,21604,71488,359994,81676,250068,-10188,109926
2017/4/5,臺指選擇權,CALL,投信,0,0,0,0,0,0,170,510,170,952,0,-442
2017/4/5,臺指選擇權,CALL,外資及陸資,41760,127136,39611,114667,2149,12469,109911,560789,27301,219128,82610,341661
2017/4/5,臺指選擇權,PUT,自營商,174811,196827,188321,201921,-13510,-5094,91711,126420,91034,89567,677,36853
2017/4/5,臺指選擇權,PUT,投信,0,0,0,0,0,0,170,21,170,31,0,-10
2017/4/5,臺指選擇權,PUT,外資及陸資,41487,79455,33112,72875,8375,6581,191966,163826,71710,75209,120256,88617
2017/4/6,臺指選擇權,CALL,自營商,87768,129981,96566,177757,-8798,-47776,75940,278636,95038,228571,-19098,50065
2017/4/6,臺指選擇權,CALL,投信,0,0,0,0,0,0,170,293,170,612,0,-319
2017/4/6,臺指選擇權,CALL,外資及陸資,23322,72234,24152,77193,-830,-4958,110865,463826,29042,186111,81823,277715
2017/4/6,臺指選擇權,PUT,自營商,152863,184635,120661,177108,32202,7527,129613,188264,96815,137632,32798,50632
2017/4/6,臺指選擇權,PUT,投信,0,0,0,0,0,0,170,23,170,39,0,-16
2017/4/6,臺指選擇權,PUT,外資及陸資,45239,96864,26481,80022,18758,16842,211471,222440,72440,99421,139031,123019
2017/4/7,臺指選擇權,CALL,自營商,199047,313019,198577,333440,470,-20421,81536,256336,100148,230036,-18612,26300
2017/4/7,臺指選擇權,CALL,投信,0,0,0,0,0,0,170,183,170,451,0,-268
2017/4/7,臺指選擇權,CALL,外資及陸資,59048,152287,56245,149302,2803,2985,115143,422662,30401,172770,84742,249892
2017/4/7,臺指選擇權,PUT,自營商,260695,400380,249341,390860,11354,9519,138220,208761,94178,131316,44042,77445
2017/4/7,臺指選擇權,PUT,投信,0,0,0,0,0,0,170,30,170,47,0,-17
2017/4/7,臺指選擇權,PUT,外資及陸資,83308,205735,57858,188358,25450,17377,236449,268203,72000,113559,164449,154644
2017/4/10,臺指選擇權,CALL,自營商,72115,114944,75475,124941,-3360,-9997,81703,263679,103448,246085,-21745,17594
2017/4/10,臺指選擇權,CALL,投信,0,0,0,0,0,0,170,179,170,451,0,-272
2017/4/10,臺指選擇權,CALL,外資及陸資,27286,73036,25384,68297,1902,4739,116648,438301,29970,176905,86678,261396
2017/4/10,臺指選擇權,PUT,自營商,94914,115142,98068,140661,-3154,-25519,141720,184373,101118,135005,40602,49368
2017/4/10,臺指選擇權,PUT,投信,0,0,0,0,0,0,170,19,170,31,0,-12
2017/4/10,臺指選擇權,PUT,外資及陸資,31768,88599,27690,72484,4078,16115,241560,265098,73057,110041,168503,155057
2017/4/11,臺指選擇權,CALL,自營商,155106,216995,150467,196251,4639,20744,90390,229760,107516,181742,-17126,48018
2017/4/11,臺指選擇權,CALL,投信,0,0,0,0,0,0,170,70,170,230,0,-160
2017/4/11,臺指選擇權,CALL,外資及陸資,38543,104215,39798,101317,-1255,2897,117131,376828,31710,149880,85421,226948
2017/4/11,臺指選擇權,PUT,自營商,156982,239383,164010,276748,-7028,-37365,146627,263353,112985,237046,33642,26307
2017/4/11,臺指選擇權,PUT,投信,0,0,0,0,0,0,170,26,170,43,0,-17
2017/4/11,臺指選擇權,PUT,外資及陸資,55114,184151,40898,119129,14216,65022,258186,437237,75432,159593,182754,277644
2017/4/12,臺指選擇權,CALL,自營商,160252,185883,169200,179342,-8948,6541,76372,237256,94871,180126,-18499,57130
2017/4/12,臺指選擇權,CALL,投信,0,0,0,0,0,0,170,34,170,149,0,-115
2017/4/12,臺指選擇權,CALL,外資及陸資,29531,68183,27454,61204,2077,6979,115957,366492,27797,134254,88160,232238
2017/4/12,臺指選擇權,PUT,自營商,162004,203486,173748,263016,-11744,-59530,89815,199689,103380,238571,-13565,-38882
2017/4/12,臺指選擇權,PUT,投信,0,0,0,0,0,0,170,18,170,29,0,-11
2017/4/12,臺指選擇權,PUT,外資及陸資,45438,123642,38422,98970,7016,24672,241224,449271,76804,156143,164420,293128
2017/4/13,臺指選擇權,CALL,自營商,126980,217050,110427,186607,16553,30444,94086,281460,95937,196851,-1851,84609
2017/4/13,臺指選擇權,CALL,投信,0,0,0,0,0,0,170,34,170,187,0,-153
2017/4/13,臺指選擇權,CALL,外資及陸資,43145,107364,33920,98085,9225,9280,122614,395868,25161,147288,97453,248580
2017/4/13,臺指選擇權,PUT,自營商,153448,182742,157570,219778,-4122,-37036,99493,165687,117038,232020,-17545,-66333
2017/4/13,臺指選擇權,PUT,投信,0,0,0,0,0,0,170,6,170,11,0,-5
2017/4/13,臺指選擇權,PUT,外資及陸資,61979,124238,34679,101948,27300,22290,269872,414473,78173,145205,191699,269268
2017/4/14,臺指選擇權,CALL,自營商,153785,208069,181179,262566,-27394,-54497,82518,168248,111863,150706,-29345,17542
2017/4/14,臺指選擇權,CALL,投信,0,0,0,0,0,0,170,5,170,20,0,-15
2017/4/14,臺指選擇權,CALL,外資及陸資,44970,117472,41706,108227,3264,9245,126033,280101,25340,98909,100693,181192
2017/4/14,臺指選擇權,PUT,自營商,205641,361966,195378,332958,10263,29008,105576,328088,112845,382282,-7269,-54194
2017/4/14,臺指選擇權,PUT,投信,0,0,0,0,0,0,170,33,170,63,0,-30
2017/4/14,臺指選擇權,PUT,外資及陸資,87811,195193,62212,185834,25599,9359,300553,699496,83222,256705,217331,442791
2017/4/17,臺指選擇權,CALL,自營商,135231,186070,141292,190574,-6061,-4505,88016,177840,123422,152187,-35406,25653
2017/4/17,臺指選擇權,CALL,投信,0,0,0,0,0,0,170,3,170,6,0,-3
2017/4/17,臺指選擇權,CALL,外資及陸資,42336,108178,36119,93077,6217,15101,133354,283082,26444,96872,106910,186210
2017/4/17,臺指選擇權,PUT,自營商,145694,270910,141051,269193,4643,1717,108209,287655,110835,336573,-2626,-48918
2017/4/17,臺指選擇權,PUT,投信,0,0,0,0,0,0,170,6,170,11,0,-5
2017/4/17,臺指選擇權,PUT,外資及陸資,58019,133296,45155,140719,12864,-7423,317205,609307,87010,235906,230195,373401
2017/4/18,臺指選擇權,CALL,自營商,100344,125389,114272,162851,-13928,-37462,88942,180291,138276,184641,-49334,-4350
2017/4/18,臺指選擇權,CALL,投信,0,0,0,0,0,0,170,1,170,3,0,-2
2017/4/18,臺指選擇權,CALL,外資及陸資,31869,75492,29997,72521,1872,2971,135136,287962,26354,99444,108782,188518
2017/4/18,臺指選擇權,PUT,自營商,113586,147968,107730,144826,5856,3142,120906,277678,117676,323097,3230,-45419
2017/4/18,臺指選擇權,PUT,投信,0,0,0,0,0,0,170,3,170,6,0,-3
2017/4/18,臺指選擇權,PUT,外資及陸資,34688,72358,27911,69737,6777,2621,320979,557683,85007,216239,235972,341444
2017/4/19,臺指選擇權,CALL,自營商,162231,191857,220186,240958,-57955,-49101,62335,109302,77425,121592,-15090,-12290
2017/4/19,臺指選擇權,CALL,投信,170,143,170,283,0,-140,170,94,170,213,0,-119
2017/4/19,臺指選擇權,CALL,外資及陸資,32306,71050,35706,67855,-3400,3195,97261,202770,14660,60055,82601,142715
2017/4/19,臺指選擇權,PUT,自營商,199699,362850,198332,340806,1367,22044,77410,259999,74628,326408,2782,-66409
2017/4/19,臺指選擇權,PUT,投信,170,511,170,707,0,-196,170,510,170,731,0,-221
2017/4/19,臺指選擇權,PUT,外資及陸資,51371,120532,45395,140254,5976,-19722,147119,625745,30165,219319,116954,406426
2017/4/20,臺指選擇權,CALL,自營商,109144,160105,97890,161539,11254,-1433,89194,135741,92979,145649,-3785,-9908
2017/4/20,臺指選擇權,CALL,投信,0,0,0,0,0,0,170,66,170,166,0,-100
2017/4/20,臺指選擇權,CALL,外資及陸資,27218,86034,24305,75995,2913,10039,99987,194762,14474,56520,85513,138242
2017/4/20,臺指選擇權,PUT,自營商,116545,203042,109769,218847,6776,-15805,95959,255113,86538,337771,9421,-82658
2017/4/20,臺指選擇權,PUT,投信,0,0,0,0,0,0,170,468,170,689,0,-221
2017/4/20,臺指選擇權,PUT,外資及陸資,47659,106075,27887,106551,19772,-476,167355,602709,30606,218304,136749,384405
2017/4/21,臺指選擇權,CALL,自營商,103837,211206,92665,169429,11172,41777,104073,222987,96723,201461,7350,21526
2017/4/21,臺指選擇權,CALL,投信,0,0,0,0,0,0,170,111,170,255,0,-144
2017/4/21,臺指選擇權,CALL,外資及陸資,40071,101277,23309,81018,16762,20259,116604,257470,14289,67332,102315,190138
2017/4/21,臺指選擇權,PUT,自營商,134625,178190,136325,178486,-1700,-297,105144,184184,97401,240994,7743,-56810
2017/4/21,臺指選擇權,PUT,投信,0,0,0,0,0,0,170,285,170,434,0,-149
2017/4/21,臺指選擇權,PUT,外資及陸資,63186,89661,28170,80790,35016,8871,204551,452167,32791,172372,171760,279795
2017/4/24,臺指選擇權,CALL,自營商,116593,214686,123834,198922,-7241,15765,98395,209164,98398,178718,-3,30446
2017/4/24,臺指選擇權,CALL,投信,0,0,0,0,0,0,170,89,170,213,0,-124
2017/4/24,臺指選擇權,CALL,外資及陸資,29856,89596,34841,109197,-4985,-19601,114233,237162,16873,74524,97360,162638
2017/4/24,臺指選擇權,PUT,自營商,152859,208685,158225,211535,-5366,-2850,108481,173369,106144,228062,2337,-54693
2017/4/24,臺指選擇權,PUT,投信,0,0,0,0,0,0,170,208,170,340,0,-132
2017/4/24,臺指選擇權,PUT,外資及陸資,33582,88182,41904,95172,-8322,-6990,199743,400414,36293,166262,163450,234152
2017/4/25,臺指選擇權,CALL,自營商,150557,295906,150034,267546,523,28360,100289,349364,99645,270114,644,79250
2017/4/25,臺指選擇權,CALL,投信,0,0,0,0,0,0,170,196,170,425,0,-229
2017/4/25,臺指選擇權,CALL,外資及陸資,38867,120261,40753,132914,-1886,-12653,114618,340966,19115,115063,95503,225903
2017/4/25,臺指選擇權,PUT,自營商,190530,213697,221576,214381,-31046,-684,114235,127955,142999,156526,-28764,-28571
2017/4/25,臺指選擇權,PUT,投信,0,0,0,0,0,0,170,94,170,153,0,-59
2017/4/25,臺指選擇權,PUT,外資及陸資,37196,83745,33166,87099,4030,-3354,207788,280914,40348,126691,167440,154223
2017/4/26,臺指選擇權,CALL,自營商,175028,312899,190572,294164,-15544,18735,80286,293617,87326,211162,-7040,82455
2017/4/26,臺指選擇權,CALL,投信,0,0,0,0,0,0,170,255,170,510,0,-255
2017/4/26,臺指選擇權,CALL,外資及陸資,39728,118035,40126,122423,-398,-4388,110475,353685,18701,116970,91774,236715
2017/4/26,臺指選擇權,PUT,自營商,195966,218472,223015,227305,-27049,-8834,81847,128729,118323,162298,-36476,-33569
2017/4/26,臺指選擇權,PUT,投信,0,0,0,0,0,0,170,80,170,123,0,-43
2017/4/26,臺指選擇權,PUT,外資及陸資,45564,79302,33863,67507,11701,11795,182204,264797,41532,114921,140672,149876
2017/4/27,臺指選擇權,CALL,自營商,76930,131594,82247,153971,-5317,-22377,86803,291247,99021,234524,-12218,56723
2017/4/27,臺指選擇權,CALL,投信,0,0,0,0,0,0,170,230,170,485,0,-255
2017/4/27,臺指選擇權,CALL,外資及陸資,21379,68664,22285,74167,-906,-5503,111884,343830,20980,122929,90904,220901
2017/4/27,臺指選擇權,PUT,自營商,114537,134251,103693,140015,10844,-5764,106469,135201,132127,169120,-25658,-33919
2017/4/27,臺指選擇權,PUT,投信,0,0,0,0,0,0,170,68,170,106,0,-38
2017/4/27,臺指選擇權,PUT,外資及陸資,44023,77388,24947,71806,19076,5582,205543,271707,45825,121877,159718,149830
2017/4/28,臺指選擇權,CALL,自營商,95368,165663,93310,177176,2058,-11513,92955,307699,103093,263327,-10138,44372
2017/4/28,臺指選擇權,CALL,投信,0,0,0,0,0,0,170,234,170,493,0,-259
2017/4/28,臺指選擇權,CALL,外資及陸資,27558,84226,30575,97619,-3017,-13394,111593,347270,23710,136888,87883,210382
2017/4/28,臺指選擇權,PUT,自營商,116732,145290,108087,131884,8645,13406,123845,143620,140872,155724,-17027,-12104
2017/4/28,臺指選擇權,PUT,投信,0,0,0,0,0,0,170,54,170,82,0,-28
2017/4/28,臺指選擇權,PUT,外資及陸資,34968,66071,27031,68007,7937,-1936,214936,243292,47251,109768,167685,133524
2017/5/2,臺指選擇權,CALL,自營商,121820,297986,110950,225763,10870,72223,101262,429796,100483,316782,779,113014
2017/5/2,臺指選擇權,CALL,投信,0,0,0,0,0,0,170,353,170,740,0,-387
2017/5/2,臺指選擇權,CALL,外資及陸資,37793,139457,31608,115857,6185,23600,116388,441197,22360,164828,94028,276369
2017/5/2,臺指選擇權,PUT,自營商,137121,158438,144751,149641,-7630,8796,126644,125084,151314,119082,-24670,6002
2017/5/2,臺指選擇權,PUT,投信,0,0,0,0,0,0,170,33,170,48,0,-15
2017/5/2,臺指選擇權,PUT,外資及陸資,28751,68098,24331,54229,4420,13869,220278,195634,48160,80992,172118,114642
2017/5/3,臺指選擇權,CALL,自營商,120257,223370,116523,197445,3734,25925,91562,394835,88068,265447,3494,129388
2017/5/3,臺指選擇權,CALL,投信,0,0,0,0,0,0,170,349,170,757,0,-408
2017/5/3,臺指選擇權,CALL,外資及陸資,27925,75870,22688,71797,5237,4074,120480,451585,20952,162411,99528,289174
2017/5/3,臺指選擇權,PUT,自營商,136679,112546,141094,120099,-4415,-7553,94219,118872,138958,122170,-44739,-3298
2017/5/3,臺指選擇權,PUT,投信,0,0,0,0,0,0,170,31,170,45,0,-14
2017/5/3,臺指選擇權,PUT,外資及陸資,23565,43802,19653,36909,3912,6894,216268,200422,46618,80794,169650,119628
2017/5/4,臺指選擇權,CALL,自營商,66573,120404,82378,167050,-15805,-46647,96116,422470,108418,333271,-12302,89199
2017/5/4,臺指選擇權,CALL,投信,0,0,0,0,0,0,170,408,170,884,0,-476
2017/5/4,臺指選擇權,CALL,外資及陸資,27964,75513,20038,66727,7926,8786,129392,492085,21972,176528,107420,315557
2017/5/4,臺指選擇權,PUT,自營商,110754,116603,88179,100674,22575,15929,118618,130898,140815,114366,-22197,16532
2017/5/4,臺指選擇權,PUT,投信,0,0,0,0,0,0,170,26,170,37,0,-11
2017/5/4,臺指選擇權,PUT,外資及陸資,25117,47418,16672,42577,8445,4841,226263,189594,48150,75567,178113,114027
2017/5/5,臺指選擇權,CALL,自營商,114398,169215,116426,207083,-2028,-37868,103892,302273,118031,255234,-14139,47039
2017/5/5,臺指選擇權,CALL,投信,0,0,0,0,0,0,170,191,170,493,0,-302
2017/5/5,臺指選擇權,CALL,外資及陸資,17870,55299,16047,47485,1823,7814,131908,390206,22593,138952,109315,251254
2017/5/5,臺指選擇權,PUT,自營商,144547,175858,135012,180811,9535,-4953,131440,192524,143997,180522,-12557,12002
2017/5/5,臺指選擇權,PUT,投信,0,0,0,0,0,0,170,35,170,54,0,-19
2017/5/5,臺指選擇權,PUT,外資及陸資,37408,63068,14887,45693,22521,17375,249925,277007,49363,104107,200562,172900
2017/5/8,臺指選擇權,CALL,自營商,106381,178404,105637,165555,744,12848,107305,341740,120335,279766,-13030,61974
2017/5/8,臺指選擇權,CALL,投信,0,0,0,0,0,0,170,221,170,587,0,-366
2017/5/8,臺指選擇權,CALL,外資及陸資,22163,56773,16708,54081,5455,2692,137638,432072,22817,153125,114821,278947
2017/5/8,臺指選擇權,PUT,自營商,133241,161303,127067,145930,6174,15374,143291,165813,149713,133805,-6422,32008
2017/5/8,臺指選擇權,PUT,投信,0,0,0,0,0,0,170,19,170,27,0,-8
2017/5/8,臺指選擇權,PUT,外資及陸資,18837,43822,14439,40673,4398,3149,254746,218616,49802,84426,204944,134190
2017/5/9,臺指選擇權,CALL,自營商,213167,358599,204848,349718,8319,8882,120026,325480,124694,258211,-4668,67269
2017/5/9,臺指選擇權,CALL,投信,0,0,0,0,0,0,170,157,170,468,0,-311
2017/5/9,臺指選擇權,CALL,外資及陸資,59356,130518,37113,112706,22243,17812,159871,423378,22801,145699,137070,277679
2017/5/9,臺指選擇權,PUT,自營商,214872,244058,229552,252884,-14680,-8827,145018,206009,166122,186194,-21104,19815
2017/5/9,臺指選擇權,PUT,投信,0,0,0,0,0,0,170,21,170,31,0,-10
2017/5/9,臺指選擇權,PUT,外資及陸資,31626,71719,29233,68128,2393,3591,259110,247108,51790,96899,207320,150209
2017/5/10,臺指選擇權,CALL,自營商,143997,196535,152669,213794,-8672,-17259,98292,376577,110870,302055,-12578,74522
2017/5/10,臺指選擇權,CALL,投信,0,0,0,0,0,0,170,242,170,680,0,-438
2017/5/10,臺指選擇權,CALL,外資及陸資,29550,63779,24603,55935,4947,7844,163613,504473,22448,169262,141165,335211
2017/5/10,臺指選擇權,PUT,自營商,160890,155780,173185,156673,-12295,-893,103612,153400,151969,130256,-48357,23144
2017/5/10,臺指選擇權,PUT,投信,0,0,0,0,0,0,170,16,170,21,0,-5
2017/5/10,臺指選擇權,PUT,外資及陸資,22723,42335,20030,44048,2693,-1713,248816,206446,53608,84315,195208,122131
2017/5/11,臺指選擇權,CALL,自營商,111697,203137,117957,271054,-6260,-67917,102060,407051,120928,394189,-18868,12862
2017/5/11,臺指選擇權,CALL,投信,0,0,0,0,0,0,170,349,170,876,0,-527
2017/5/11,臺指選擇權,CALL,外資及陸資,27380,96823,31217,112674,-3837,-15851,159905,560952,22566,193699,137339,367253
2017/5/11,臺指選擇權,PUT,自營商,169707,162962,146281,154175,23426,8786,123166,144983,148107,110582,-24941,34401
2017/5/11,臺指選擇權,PUT,投信,0,0,0,0,0,0,170,3,170,6,0,-3
2017/5/11,臺指選擇權,PUT,外資及陸資,21807,44384,18482,50296,3325,-5912,252100,167677,53549,73667,198551,94010
2017/5/12,臺指選擇權,CALL,自營商,74425,93043,68770,107162,5655,-14119,113770,387452,126677,382595,-12907,4857
2017/5/12,臺指選擇權,CALL,投信,0,0,0,0,0,0,170,255,170,791,0,-536
2017/5/12,臺指選擇權,CALL,外資及陸資,15990,45735,16782,50864,-792,-5129,159825,533863,23282,189749,136543,344114
2017/5/12,臺指選擇權,PUT,自營商,110672,104334,86804,90322,23868,14012,146479,163499,147545,115194,-1066,48305
2017/5/12,臺指選擇權,PUT,投信,0,0,0,0,0,0,170,3,170,3,0,0
2017/5/12,臺指選擇權,PUT,外資及陸資,13941,32643,12546,32925,1395,-281,253960,167790,53994,75137,199966,92653
2017/5/15,臺指選擇權,CALL,自營商,104745,301870,93682,276387,11063,25483,120648,483462,121545,439430,-897,44032
2017/5/15,臺指選擇權,CALL,投信,0,0,0,0,0,0,170,361,170,1097,0,-736
2017/5/15,臺指選擇權,CALL,外資及陸資,29315,69999,18289,66238,11026,3760,170916,621345,23418,221975,147498,399370
2017/5/15,臺指選擇權,PUT,自營商,130315,147774,137323,115206,-7008,32568,148477,163137,156289,95302,-7812,67835
2017/5/15,臺指選擇權,PUT,投信,0,0,0,0,0,0,170,2,170,2,0,0
2017/5/15,臺指選擇權,PUT,外資及陸資,17199,46127,13791,38106,3408,8021,258797,155234,55443,69565,203354,85669
2017/5/16,臺指選擇權,CALL,自營商,87623,155330,92289,181524,-4666,-26194,120976,462149,126597,429997,-5621,32152
2017/5/16,臺指選擇權,CALL,投信,0,0,0,0,0,0,170,272,170,1037,0,-765
2017/5/16,臺指選擇權,CALL,外資及陸資,13920,49669,13102,52883,818,-3214,171561,588470,23264,214688,148297,373782
2017/5/16,臺指選擇權,PUT,自營商,107316,127304,118771,156675,-11455,-29371,145837,150530,165105,106558,-19268,43972
2017/5/16,臺指選擇權,PUT,投信,0,0,0,0,0,0,170,2,170,2,0,0
2017/5/16,臺指選擇權,PUT,外資及陸資,11988,31169,7071,26297,4917,4872,264484,157074,56213,69357,208271,87717
2017/5/17,臺指選擇權,CALL,自營商,136777,248685,140275,213324,-3498,35361,70258,220711,71283,186165,-1025,34546
2017/5/17,臺指選擇權,CALL,投信,180,319,180,928,0,-609,180,329,180,963,0,-634
2017/5/17,臺指選擇權,CALL,外資及陸資,19774,60327,19561,57092,213,3235,112711,440477,12735,95706,99976,344771
2017/5/17,臺指選擇權,PUT,自營商,157641,300922,176021,328858,-18380,-27936,78362,148002,87365,123565,-9003,24437
2017/5/17,臺指選擇權,PUT,投信,180,378,180,553,0,-175,180,333,180,513,0,-180
2017/5/17,臺指選擇權,PUT,外資及陸資,33011,62938,17779,48993,15232,13944,126359,192466,32216,85976,94143,106490
2017/5/18,臺指選擇權,CALL,自營商,115312,217210,106503,205234,8809,11976,89904,249729,82150,200647,7754,49082
2017/5/18,臺指選擇權,CALL,投信,0,0,0,0,0,0,180,266,180,864,0,-598
2017/5/18,臺指選擇權,CALL,外資及陸資,27144,81927,20501,69882,6643,12045,120151,417634,13536,91068,106615,326566
2017/5/18,臺指選擇權,PUT,自營商,175974,289691,155306,313367,20668,-23675,118732,200948,107116,195884,11616,5064
2017/5/18,臺指選擇權,PUT,投信,0,0,0,0,0,0,180,387,180,585,0,-198
2017/5/18,臺指選擇權,PUT,外資及陸資,48589,116075,19062,63477,29527,52598,155133,258563,31515,88597,123618,169966
2017/5/19,臺指選擇權,CALL,自營商,56031,95845,60998,115643,-4967,-19798,100606,234823,97844,207948,2762,26875
2017/5/19,臺指選擇權,CALL,投信,0,0,0,0,0,0,180,212,180,738,0,-526
2017/5/19,臺指選擇權,CALL,外資及陸資,12756,38519,10610,40230,2146,-1711,122794,385496,14040,88158,108754,297338
2017/5/19,臺指選擇權,PUT,自營商,97633,112666,79208,132072,18425,-19406,145477,217389,115447,233508,30030,-16119
2017/5/19,臺指選擇權,PUT,投信,0,0,0,0,0,0,180,405,180,612,0,-207
2017/5/19,臺指選擇權,PUT,外資及陸資,23939,52392,13504,41448,10435,10944,167985,286450,33921,98414,134064,188036
2017/5/22,臺指選擇權,CALL,自營商,65189,122887,76091,145080,-10902,-22193,102845,273434,110983,274004,-8138,-570
2017/5/22,臺指選擇權,CALL,投信,0,0,0,0,0,0,180,243,180,837,0,-594
2017/5/22,臺指選擇權,CALL,外資及陸資,13962,47521,13400,46439,562,1081,124251,423098,14936,98962,109315,324136
2017/5/22,臺指選擇權,PUT,自營商,102806,124275,101541,129215,1265,-4940,153503,178479,122208,191572,31295,-13093
2017/5/22,臺指選擇權,PUT,投信,0,0,0,0,0,0,180,266,180,428,0,-162
2017/5/22,臺指選擇權,PUT,外資及陸資,13365,41981,10987,30946,2378,11035,171282,236098,34836,77242,136446,158856
2017/5/23,臺指選擇權,CALL,自營商,90752,179907,86904,173406,3848,6501,103849,285359,108239,290374,-4390,-5015
2017/5/23,臺指選擇權,CALL,投信,0,0,0,0,0,0,180,252,180,873,0,-621
2017/5/23,臺指選擇權,CALL,外資及陸資,25219,73269,17424,64830,7795,8438,134053,455116,16943,111318,117110,343798
2017/5/23,臺指選擇權,PUT,自營商,115094,161445,113537,139377,1557,22068,167076,194141,134233,182912,32843,11229
2017/5/23,臺指選擇權,PUT,投信,0,0,0,0,0,0,180,198,180,333,0,-135
2017/5/23,臺指選擇權,PUT,外資及陸資,15147,49741,18812,50019,-3665,-277,170859,211310,38098,73689,132761,137621
2017/5/24,臺指選擇權,CALL,自營商,108005,253390,113009,211435,-5004,41955,84082,271056,95920,259128,-11838,11928
2017/5/24,臺指選擇權,CALL,投信,0,0,0,0,0,0,180,257,180,936,0,-679
2017/5/24,臺指選擇權,CALL,外資及陸資,17474,57189,15672,59775,1802,-2587,132468,481224,15748,112981,116720,368243
2017/5/24,臺指選擇權,PUT,自營商,106276,122115,121604,129985,-15328,-7869,112905,159444,122562,163516,-9657,-4072
2017/5/24,臺指選擇權,PUT,投信,0,0,0,0,0,0,180,144,180,252,0,-108
2017/5/24,臺指選擇權,PUT,外資及陸資,13391,41086,10342,31872,3049,9215,163968,194517,38358,63159,125610,131358
2017/5/25,臺指選擇權,CALL,自營商,112194,220260,106083,209156,6111,11103,103459,399218,109187,361200,-5728,38018
2017/5/25,臺指選擇權,CALL,投信,60,385,0,0,60,385,180,468,120,942,60,-474
2017/5/25,臺指選擇權,CALL,外資及陸資,25756,83352,15714,70573,10042,12779,142939,637657,16184,138043,126755,499614
2017/5/25,臺指選擇權,PUT,自營商,153817,192198,137956,165312,15861,26886,143184,158507,136995,137958,6189,20549
2017/5/25,臺指選擇權,PUT,投信,0,0,0,0,0,0,180,77,180,135,0,-58
2017/5/25,臺指選擇權,PUT,外資及陸資,21162,53098,13381,44643,7781,8455,173045,157664,39659,48657,133386,109007
2017/5/26,臺指選擇權,CALL,自營商,97979,171243,96915,190929,1064,-19686,115172,378025,119836,357875,-4664,20150
2017/5/26,臺指選擇權,CALL,投信,0,0,0,0,0,0,180,414,120,882,60,-468
2017/5/26,臺指選擇權,CALL,外資及陸資,20034,67993,15935,64501,4099,3492,148543,614712,17696,136507,130847,478205
2017/5/26,臺指選擇權,PUT,自營商,130687,164600,122535,175533,8152,-10934,162220,192675,147882,181209,14338,11466
2017/5/26,臺指選擇權,PUT,投信,0,0,0,0,0,0,180,90,180,162,0,-72
2017/5/26,臺指選擇權,PUT,外資及陸資,21447,52187,15578,43993,5869,8193,180276,182538,41022,57247,139254,125291
2017/5/31,臺指選擇權,CALL,自營商,109643,195379,115444,181276,-5801,14104,92641,278523,112355,272922,-19714,5601
2017/5/31,臺指選擇權,CALL,投信,0,0,0,0,0,0,180,221,120,600,60,-379
2017/5/31,臺指選擇權,CALL,外資及陸資,17964,52760,17059,52977,905,-216,146306,488157,16922,113080,129384,375077
2017/5/31,臺指選擇權,PUT,自營商,122132,203085,120957,185876,1175,17209,119215,220039,135096,178281,-15881,41758
2017/5/31,臺指選擇權,PUT,投信,0,0,0,0,0,0,180,108,180,198,0,-90
2017/5/31,臺指選擇權,PUT,外資及陸資,20851,56808,17215,45275,3636,11533,179756,217002,41945,66120,137811,150882
2017/6/1,臺指選擇權,CALL,自營商,74809,121387,77201,172318,-2392,-50931,103543,316550,125652,360114,-22109,-43564
2017/6/1,臺指選擇權,CALL,投信,0,0,0,0,0,0,180,266,120,726,60,-460
2017/6/1,臺指選擇權,CALL,外資及陸資,12700,41882,8938,37785,3762,4097,150539,546131,17393,124960,133146,421171
2017/6/1,臺指選擇權,PUT,自營商,100874,132626,78820,119260,22054,13366,147309,211139,141140,163536,6169,47603
2017/6/1,臺指選擇權,PUT,投信,0,0,0,0,0,0,180,74,180,135,0,-61
2017/6/1,臺指選擇權,PUT,外資及陸資,11469,27951,8201,27377,3268,574,183533,187734,42456,55668,141077,132066
2017/6/2,臺指選擇權,CALL,自營商,92791,217131,92739,168824,52,48306,107605,420569,129662,424348,-22057,-3779
2017/6/2,臺指選擇權,CALL,投信,0,0,0,0,0,0,180,410,120,990,60,-580
2017/6/2,臺指選擇權,CALL,外資及陸資,19934,75392,14683,72628,5251,2764,155436,663969,17045,146216,138391,517753
2017/6/2,臺指選擇權,PUT,自營商,123732,150647,116483,109976,7249,40671,160358,202073,146942,134243,13416,67830
2017/6/2,臺指選擇權,PUT,投信,0,0,0,0,0,0,180,47,180,79,0,-32
2017/6/2,臺指選擇權,PUT,外資及陸資,17418,43117,12528,37552,4890,5565,188843,159787,42882,45118,145961,114669
2017/6/3,臺指選擇權,CALL,自營商,40002,83147,42419,86451,-2417,-3303,111631,452749,136114,454904,-24483,-2155
2017/6/3,臺指選擇權,CALL,投信,0,0,0,0,0,0,180,450,120,1074,60,-624
2017/6/3,臺指選擇權,CALL,外資及陸資,2565,8777,1849,8663,716,114,156933,692812,17826,155002,139107,537810
2017/6/3,臺指選擇權,PUT,自營商,60676,95983,64307,62291,-3631,33693,162840,207405,153055,121810,9785,85595
2017/6/3,臺指選擇權,PUT,投信,0,0,0,0,0,0,180,33,180,54,0,-21
2017/6/3,臺指選擇權,PUT,外資及陸資,3031,10040,1792,6786,1239,3254,190635,143900,43435,41676,147200,102224
2017/6/5,臺指選擇權,CALL,自營商,112384,230222,114990,285412,-2606,-55190,108332,513607,135421,580863,-27089,-67256
2017/6/5,臺指選擇權,CALL,投信,0,0,0,0,0,0,180,639,120,1320,60,-681
2017/6/5,臺指選擇權,CALL,外資及陸資,18683,71254,17524,64740,1159,6514,157563,810348,17297,169020,140266,641328
2017/6/5,臺指選擇權,PUT,自營商,135660,167216,156283,156929,-20623,10287,161729,192824,172567,119959,-10838,72865
2017/6/5,臺指選擇權,PUT,投信,0,0,0,0,0,0,180,36,180,53,0,-17
2017/6/5,臺指選擇權,PUT,外資及陸資,21884,47152,15605,31350,6279,15802,198079,146727,44600,37865,153479,108862
2017/6/6,臺指選擇權,CALL,自營商,59431,129220,60629,131416,-1198,-2196,106200,455858,134498,517897,-28298,-62039
2017/6/6,臺指選擇權,CALL,投信,0,0,0,0,0,0,180,549,120,1230,60,-681
2017/6/6,臺指選擇權,CALL,外資及陸資,8538,31893,8756,37860,-218,-5967,157936,757759,17888,163937,140048,593822
2017/6/6,臺指選擇權,PUT,自營商,76559,94704,80767,84064,-4208,10640,159204,219136,174250,126482,-15046,92654
2017/6/6,臺指選擇權,PUT,投信,0,0,0,0,0,0,180,32,180,50,0,-18
2017/6/6,臺指選擇權,PUT,外資及陸資,9414,27471,6456,17894,2958,9577,200836,156031,44399,36999,156437,119032
2017/6/7,臺指選擇權,CALL,自營商,135915,290196,144634,274661,-8719,15536,92746,394043,129573,466526,-36827,-72483
2017/6/7,臺指選擇權,CALL,投信,0,0,0,0,0,0,180,540,120,1236,60,-696
2017/6/7,臺指選擇權,CALL,外資及陸資,23846,77134,20988,77101,2858,33,157211,751834,17111,159444,140100,592390
2017/6/7,臺指選擇權,PUT,自營商,144375,158798,161374,154823,-16999,3976,130747,214194,159689,131829,-28942,82365
2017/6/7,臺指選擇權,PUT,投信,0,0,0,0,0,0,180,27,180,41,0,-14
2017/6/7,臺指選擇權,PUT,外資及陸資,17660,46304,18876,45859,-1216,445,195778,152964,45332,36555,150446,116409
2017/6/8,臺指選擇權,CALL,自營商,68203,134927,72072,182296,-3869,-47369,99196,417206,139903,546389,-40707,-129183
2017/6/8,臺指選擇權,CALL,投信,0,0,0,0,0,0,180,621,120,1344,60,-723
2017/6/8,臺指選擇權,CALL,外資及陸資,10102,40473,10969,49916,-867,-9443,158304,803102,19074,177423,139230,625679
2017/6/8,臺指選擇權,PUT,自營商,94118,94365,81387,91913,12731,2453,149056,202449,165248,127924,-16192,74525
2017/6/8,臺指選擇權,PUT,投信,0,0,0,0,0,0,180,20,180,32,0,-12
2017/6/8,臺指選擇權,PUT,外資及陸資,13182,27256,8646,25892,4536,1364,202900,142027,47938,34635,154962,107392
2017/6/9,臺指選擇權,CALL,自營商,101462,207357,94339,171470,7123,35887,106678,379323,140269,455342,-33591,-76019
2017/6/9,臺指選擇權,CALL,投信,0,0,0,0,0,0,180,459,120,1206,60,-747
2017/6/9,臺指選擇權,CALL,外資及陸資,16714,60149,12931,58403,3783,1746,160835,715363,17822,157612,143013,557751
2017/6/9,臺指選擇權,PUT,自營商,112872,142967,112270,130642,602,12324,155133,235440,170723,140136,-15590,95304
2017/6/9,臺指選擇權,PUT,投信,0,0,0,0,0,0,180,15,180,23,0,-8
2017/6/9,臺指選擇權,PUT,外資及陸資,14298,45691,13761,39539,537,6152,206935,150197,51436,37992,155499,112205
2017/6/12,臺指選擇權,CALL,自營商,185390,217771,164350,185071,21040,32700,147545,337733,160097,370059,-12552,-32326
2017/6/12,臺指選擇權,CALL,投信,0,0,0,0,0,0,180,212,120,834,60,-622
2017/6/12,臺指選擇權,CALL,外資及陸資,13712,39230,12953,38529,759,702,162302,566067,18529,134702,143773,431365
2017/6/12,臺指選擇權,PUT,自營商,161919,236704,169197,270487,-7278,-33783,163343,359129,186211,246115,-22868,113014
2017/6/12,臺指選擇權,PUT,投信,0,0,0,0,0,0,180,22,180,38,0,-16
2017/6/12,臺指選擇權,PUT,外資及陸資,37733,92620,14630,48879,23103,43741,230001,239186,51399,55489,178602,183697
2017/6/13,臺指選擇權,CALL,自營商,111149,114946,122676,124418,-11527,-9471,152514,356713,176594,394085,-24080,-37372
2017/6/13,臺指選擇權,CALL,投信,0,0,0,0,0,0,180,207,120,894,60,-687
2017/6/13,臺指選擇權,CALL,外資及陸資,11526,32150,11702,34871,-176,-2721,163173,581090,19576,141809,143597,439281
2017/6/13,臺指選擇權,PUT,自營商,114067,137689,114878,128489,-811,9199,168893,322661,192572,208372,-23679,114289
2017/6/13,臺指選擇權,PUT,投信,0,0,0,0,0,0,180,14,180,24,0,-10
2017/6/13,臺指選擇權,PUT,外資及陸資,14929,41262,12872,34315,2057,6947,233062,213068,52402,47928,180660,165140
2017/6/14,臺指選擇權,CALL,自營商,266275,280244,305652,308944,-39377,-28700,111350,246360,164919,308439,-53569,-62079
2017/6/14,臺指選擇權,CALL,投信,0,0,0,0,0,0,180,61,120,540,60,-479
2017/6/14,臺指選擇權,CALL,外資及陸資,31801,75967,33781,76062,-1980,-95,157867,453450,22604,122701,135263,330749
2017/6/14,臺指選擇權,PUT,自營商,329613,451037,318834,471833,10779,-20797,140875,381459,166649,257324,-25774,124135
2017/6/14,臺指選擇權,PUT,投信,0,0,0,0,0,0,180,25,180,41,0,-16
2017/6/14,臺指選擇權,PUT,外資及陸資,56121,141213,51360,153190,4761,-11977,230858,287267,51930,73827,178928,213440
2017/6/15,臺指選擇權,CALL,自營商,115860,150937,117813,185558,-1953,-34621,126182,248050,181707,347125,-55525,-99075
2017/6/15,臺指選擇權,CALL,投信,0,0,0,0,0,0,180,38,120,546,60,-508
2017/6/15,臺指選擇權,CALL,外資及陸資,22617,61204,22838,60202,-221,1002,158588,454848,23546,123516,135042,331332
2017/6/15,臺指選擇權,PUT,自營商,157336,195579,124003,207181,33333,-11602,154446,352208,146890,241796,7556,110412
2017/6/15,臺指選擇權,PUT,投信,0,0,0,0,0,0,180,5,180,14,0,-9
2017/6/15,臺指選擇權,PUT,外資及陸資,29111,78599,31698,85894,-2587,-7294,230163,260000,53821,70475,176342,189525
2017/6/16,臺指選擇權,CALL,自營商,140529,301262,126214,234476,14315,66786,132008,374142,173220,405177,-41212,-31035
2017/6/16,臺指選擇權,CALL,投信,0,0,0,0,0,0,180,104,120,906,60,-802
2017/6/16,臺指選擇權,CALL,外資及陸資,26049,84084,22776,76384,3273,7700,162271,579617,23958,153694,138313,425923
2017/6/16,臺指選擇權,PUT,自營商,154636,176744,160963,194695,-6327,-17952,165033,241168,163807,173671,1226,67497
2017/6/16,臺指選擇權,PUT,投信,0,0,0,0,0,0,180,4,180,5,0,-1
2017/6/16,臺指選擇權,PUT,外資及陸資,27018,61567,26114,61109,904,458,231642,184696,54405,47824,177237,136872
2017/6/19,臺指選擇權,CALL,自營商,149893,304945,149541,328030,352,-23085,129243,556230,170103,605957,-40860,-49727
2017/6/19,臺指選擇權,CALL,投信,0,0,0,0,0,0,180,450,120,1446,60,-996
2017/6/19,臺指選擇權,CALL,外資及陸資,33485,108862,35258,116568,-1773,-7706,166279,806774,29739,220727,136540,586047
2017/6/19,臺指選擇權,PUT,自營商,143517,158507,170394,145875,-26877,12632,168687,170982,194338,127862,-25651,43120
2017/6/19,臺指選擇權,PUT,投信,0,0,0,0,0,0,180,2,180,3,0,-1
2017/6/19,臺指選擇權,PUT,外資及陸資,20112,49330,20052,42595,60,6735,233490,133659,56194,31355,177296,102304
2017/6/20,臺指選擇權,CALL,自營商,257110,569258,247341,556095,9769,13163,125578,734316,156669,816419,-31091,-82103
2017/6/20,臺指選擇權,CALL,投信,0,0,0,0,0,0,180,1125,120,1938,60,-813
2017/6/20,臺指選擇權,CALL,外資及陸資,57715,188135,42469,161782,15246,26354,175482,1102576,23693,273219,151789,829357
2017/6/20,臺指選擇權,PUT,自營商,206410,205033,239975,197586,-33565,7447,161532,136226,220749,105526,-59217,30700
2017/6/20,臺指選擇權,PUT,投信,0,0,0,0,0,0,180,2,180,2,0,0
2017/6/20,臺指選擇權,PUT,外資及陸資,31460,61001,28904,56470,2556,4531,240538,115014,60686,30824,179852,84190
2017/6/21,臺指選擇權,CALL,自營商,241760,442731,242011,417163,-251,25568,64853,255882,77665,315466,-12812,-59584
2017/6/21,臺指選擇權,CALL,投信,175,197,175,361,0,-164,175,228,175,446,0,-218
2017/6/21,臺指選擇權,CALL,外資及陸資,49466,126424,45012,118301,4454,8123,93720,467542,10631,103534,83089,364008
2017/6/21,臺指選擇權,PUT,自營商,220431,222384,250565,272177,-30134,-49793,79823,117577,84789,136835,-4966,-19258
2017/6/21,臺指選擇權,PUT,投信,175,273,175,439,0,-166,175,241,175,385,0,-144
2017/6/21,臺指選擇權,PUT,外資及陸資,38106,77380,37811,83805,295,-6425,90249,117889,21551,40431,68698,77458
2017/6/22,臺指選擇權,CALL,自營商,105620,189614,105334,197852,286,-8238,78980,306090,91508,381872,-12528,-75782
2017/6/22,臺指選擇權,CALL,投信,0,0,0,0,0,0,175,319,175,595,0,-276
2017/6/22,臺指選擇權,CALL,外資及陸資,36192,104319,29852,98557,6340,5762,102980,555991,13551,123028,89429,432963
2017/6/22,臺指選擇權,PUT,自營商,151920,207599,128228,198060,23692,9539,108766,124451,90040,121777,18726,2674
2017/6/22,臺指選擇權,PUT,投信,0,0,0,0,0,0,175,140,175,249,0,-109
2017/6/22,臺指選擇權,PUT,外資及陸資,43648,116193,32333,95177,11315,21016,104867,132234,24854,44343,80013,87891
2017/6/23,臺指選擇權,CALL,自營商,78615,121862,79788,119425,-1173,2438,87391,294992,101091,363517,-13700,-68525
2017/6/23,臺指選擇權,CALL,投信,0,0,0,0,0,0,175,267,175,525,0,-258
2017/6/23,臺指選擇權,CALL,外資及陸資,26309,68238,23007,67726,3302,512,107753,531870,15025,121506,92728,410364
2017/6/23,臺指選擇權,PUT,自營商,102443,121685,92137,148290,10306,-26606,129090,147384,100058,169592,29032,-22208
2017/6/23,臺指選擇權,PUT,投信,0,0,0,0,0,0,175,158,175,276,0,-118
2017/6/23,臺指選擇權,PUT,外資及陸資,23516,63459,19786,56158,3730,7301,109872,150345,26129,49814,83743,100531
2017/6/26,臺指選擇權,CALL,自營商,246875,572849,248437,642924,-1562,-70075,103620,564089,118885,741196,-15265,-177107
2017/6/26,臺指選擇權,CALL,投信,0,0,0,0,0,0,175,875,175,1374,0,-499
2017/6/26,臺指選擇權,CALL,外資及陸資,93443,327635,91711,351980,1732,-24345,118286,976409,23826,240705,94460,735704
2017/6/26,臺指選擇權,PUT,自營商,250239,349383,264107,312880,-13868,36503,140177,150331,125018,104597,15159,45734
2017/6/26,臺指選擇權,PUT,投信,0,0,0,0,0,0,175,101,175,162,0,-61
2017/6/26,臺指選擇權,PUT,外資及陸資,49945,113457,52760,116336,-2815,-2879,114897,126103,33964,47259,80933,78844
2017/6/27,臺指選擇權,CALL,自營商,156067,249320,155607,347455,460,-98135,119333,512729,134121,767691,-14788,-254962
2017/6/27,臺指選擇權,CALL,投信,0,0,0,0,0,0,175,823,175,1313,0,-490
2017/6/27,臺指選擇權,CALL,外資及陸資,37369,120350,39080,133680,-1711,-13330,119830,949756,27104,248009,92726,701747
2017/6/27,臺指選擇權,PUT,自營商,167883,221800,150107,214480,17776,7319,151139,184504,118191,120105,32948,64399
2017/6/27,臺指選擇權,PUT,投信,0,0,0,0,0,0,175,109,175,166,0,-57
2017/6/27,臺指選擇權,PUT,外資及陸資,18180,49358,18545,50712,-365,-1354,118640,140092,38087,59250,80553,80842
2017/6/28,臺指選擇權,CALL,自營商,244729,346687,255232,324130,-10503,22557,87047,335373,116988,496562,-29941,-161189
2017/6/28,臺指選擇權,CALL,投信,0,0,0,0,0,0,175,464,175,796,0,-332
2017/6/28,臺指選擇權,CALL,外資及陸資,50166,121800,49447,126812,719,-5012,117409,698935,27655,172138,89754,526797
2017/6/28,臺指選擇權,PUT,自營商,256406,416781,255369,436277,1037,-19496,112140,249679,85688,165329,26452,84350
2017/6/28,臺指選擇權,PUT,投信,0,0,0,0,0,0,175,188,175,302,0,-114
2017/6/28,臺指選擇權,PUT,外資及陸資,72692,175981,56144,146086,16548,29895,127310,222270,30032,83204,97278,139066
2017/6/29,臺指選擇權,CALL,自營商,147584,238465,131451,239965,16133,-1500,108996,364728,122805,529341,-13809,-164613
2017/6/29,臺指選擇權,CALL,投信,0,0,0,0,0,0,175,499,175,866,0,-367
2017/6/29,臺指選擇權,CALL,外資及陸資,30909,98738,35142,117904,-4233,-19167,118830,738951,33309,202213,85521,536738
2017/6/29,臺指選擇權,PUT,自營商,154571,249546,130403,251927,24168,-2380,144989,226957,94369,165970,50620,60987
2017/6/29,臺指選擇權,PUT,投信,0,0,0,0,0,0,175,127,175,201,0,-74
2017/6/29,臺指選擇權,PUT,外資及陸資,45196,113851,36324,113208,8872,643,140468,203417,34319,87684,106149,115733
2017/6/30,臺指選擇權,CALL,自營商,131041,191606,134440,219735,-3399,-28129,118364,328087,135572,497543,-17208,-169456
2017/6/30,臺指選擇權,CALL,投信,0,0,0,0,0,0,175,394,175,700,0,-306
2017/6/30,臺指選擇權,CALL,外資及陸資,34216,99896,28541,84861,5675,15035,126070,694811,34874,188551,91196,506260
2017/6/30,臺指選擇權,PUT,自營商,148915,287822,138533,282230,10382,5591,161646,278787,100645,202592,61001,76195
2017/6/30,臺指選擇權,PUT,投信,0,0,0,0,0,0,175,153,175,254,0,-101
2017/6/30,臺指選擇權,PUT,外資及陸資,51659,154332,36415,124308,15244,30024,157036,271067,35644,110273,121392,160794
2017/7/3,臺指選擇權,CALL,自營商,113219,175758,106504,173327,6715,2431,132019,364146,142512,541751,-10493,-177605
2017/7/3,臺指選擇權,CALL,投信,0,0,0,0,0,0,175,416,175,779,0,-363
2017/7/3,臺指選擇權,CALL,外資及陸資,27295,80795,29163,90663,-1868,-9869,125915,726148,36588,208231,89327,517917
2017/7/3,臺指選擇權,PUT,自營商,118777,198900,121610,170766,-2833,28133,163734,229260,105567,145693,58167,83567
2017/7/3,臺指選擇權,PUT,投信,0,0,0,0,0,0,175,96,175,162,0,-66
2017/7/3,臺指選擇權,PUT,外資及陸資,29140,70196,27688,69500,1452,696,159691,227710,36847,91413,122844,136297
2017/7/4,臺指選擇權,CALL,自營商,179849,230612,170617,235143,9232,-4531,140482,273232,141744,395403,-1262,-122171
2017/7/4,臺指選擇權,CALL,投信,0,0,0,0,0,0,175,201,175,455,0,-254
2017/7/4,臺指選擇權,CALL,外資及陸資,37647,103625,35516,100226,2131,3399,128344,579553,36885,162766,91459,416787
2017/7/4,臺指選擇權,PUT,自營商,162396,223998,177312,257420,-14916,-33422,160106,299569,116855,223199,43251,76370
2017/7/4,臺指選擇權,PUT,投信,0,0,0,0,0,0,175,149,175,245,0,-96
2017/7/4,臺指選擇權,PUT,外資及陸資,52384,111581,36156,97391,16228,14191,177172,311228,38100,127318,139072,183910
2017/7/5,臺指選擇權,CALL,自營商,273675,382357,286846,368559,-13171,13799,81219,335951,119438,497699,-38219,-161748
2017/7/5,臺指選擇權,CALL,投信,0,0,0,0,0,0,175,376,175,726,0,-350
2017/7/5,臺指選擇權,CALL,外資及陸資,46006,124919,45342,126742,664,-1823,126628,716080,34550,208452,92078,507628
2017/7/5,臺指選擇權,PUT,自營商,269441,386549,290938,389156,-21497,-2606,123520,199230,112320,156617,11200,42613
2017/7/5,臺指選擇權,PUT,投信,0,0,0,0,0,0,175,71,175,118,0,-47
2017/7/5,臺指選擇權,PUT,外資及陸資,58768,150932,48852,137296,9916,13636,171920,231833,35935,81488,135985,150345
2017/7/6,臺指選擇權,CALL,自營商,130740,186154,132866,227202,-2126,-41048,101393,305315,141738,481675,-40345,-176360
2017/7/6,臺指選擇權,CALL,投信,0,0,0,0,0,0,175,276,175,569,0,-293
2017/7/6,臺指選擇權,CALL,外資及陸資,33072,93565,34593,100977,-1521,-7412,127123,655105,36567,197330,90556,457775
2017/7/6,臺指選擇權,PUT,自營商,154599,208721,110646,187331,43953,21391,165264,256248,110111,185360,55153,70888
2017/7/6,臺指選擇權,PUT,投信,0,0,0,0,0,0,175,77,175,131,0,-54
2017/7/6,臺指選擇權,PUT,外資及陸資,40556,109582,32514,99251,8042,10331,181603,275552,37576,97923,144027,177629
2017/7/7,臺指選擇權,CALL,自營商,129891,194531,128693,195515,1198,-983,111428,256900,150575,380147,-39147,-123247
2017/7/7,臺指選擇權,CALL,投信,0,0,0,0,0,0,175,149,175,337,0,-188
2017/7/7,臺指選擇權,CALL,外資及陸資,35896,98174,34429,99517,1467,-1343,129929,549948,37906,167742,92023,382206
2017/7/7,臺指選擇權,PUT,自營商,140262,294662,130643,276795,9619,17867,178025,344878,113253,233976,64772,110902
2017/7/7,臺指選擇權,PUT,投信,0,0,0,0,0,0,175,109,175,201,0,-92
2017/7/7,臺指選擇權,PUT,外資及陸資,48798,154382,40917,136832,7881,17551,189474,353354,37567,122336,151907,231018
2017/7/10,臺指選擇權,CALL,自營商,136721,150554,120293,148151,16428,2403,124307,253804,147026,360501,-22719,-106697
2017/7/10,臺指選擇權,CALL,投信,0,0,0,0,0,0,175,109,175,284,0,-175
2017/7/10,臺指選擇權,CALL,外資及陸資,29971,82493,32752,87125,-2781,-4632,130573,533388,41331,167118,89242,366270
2017/7/10,臺指選擇權,PUT,自營商,137514,204220,139116,231199,-1602,-26978,186413,300275,123243,238008,63170,62267
2017/7/10,臺指選擇權,PUT,投信,0,0,0,0,0,0,175,67,175,131,0,-64
2017/7/10,臺指選擇權,PUT,外資及陸資,40619,114640,38277,111590,2342,3051,192783,319884,38535,115467,154248,204417
2017/7/11,臺指選擇權,CALL,自營商,191071,347341,173818,339690,17253,7651,139676,437298,145143,601171,-5467,-163873
2017/7/11,臺指選擇權,CALL,投信,0,0,0,0,0,0,175,324,175,753,0,-429
2017/7/11,臺指選擇權,CALL,外資及陸資,52403,175593,49110,165022,3293,10572,135571,785181,43036,257596,92535,527585
2017/7/11,臺指選擇權,PUT,自營商,199014,237891,227521,230347,-28507,7544,186186,182881,151523,125980,34663,56901
2017/7/11,臺指選擇權,PUT,投信,0,0,0,0,0,0,175,20,175,36,0,-16
2017/7/11,臺指選擇權,PUT,外資及陸資,40762,90603,36408,85571,4354,5032,199812,201839,41211,63846,158601,137993
2017/7/12,臺指選擇權,CALL,自營商,196509,334350,217248,330360,-20739,3990,85716,361687,126553,496419,-40837,-134732
2017/7/12,臺指選擇權,CALL,投信,0,0,0,0,0,0,175,293,175,700,0,-407
2017/7/12,臺指選擇權,CALL,外資及陸資,54356,161138,58103,171981,-3747,-10842,131609,745117,44449,245077,87160,500040
2017/7/12,臺指選擇權,PUT,自營商,208665,223850,240190,211596,-31525,12254,128536,200720,125417,127454,3119,73266
2017/7/12,臺指選擇權,PUT,投信,0,0,0,0,0,0,175,22,175,36,0,-14
2017/7/12,臺指選擇權,PUT,外資及陸資,58027,84618,40712,74763,17315,9854,214259,212322,37459,62723,176800,149599
2017/7/13,臺指選擇權,CALL,自營商,185777,356800,158091,342246,27686,14554,115752,464011,128905,662648,-13153,-198637
2017/7/13,臺指選擇權,CALL,投信,0,0,0,0,0,0,175,534,175,1173,0,-639
2017/7/13,臺指選擇權,CALL,外資及陸資,52855,174968,50545,178420,2310,-3451,135315,927627,45845,319118,89470,608509
2017/7/13,臺指選擇權,PUT,自營商,184835,244443,175094,235649,9741,8794,144293,149447,131433,110913,12860,38534
2017/7/13,臺指選擇權,PUT,投信,0,0,0,0,0,0,175,4,175,7,0,-3
2017/7/13,臺指選擇權,PUT,外資及陸資,50392,123630,42814,121999,7578,1631,226060,174526,41682,62538,184378,111988
2017/7/14,臺指選擇權,CALL,自營商,75588,101952,81827,144763,-6239,-42811,121373,418232,140767,629159,-19394,-210927
2017/7/14,臺指選擇權,CALL,投信,0,0,0,0,0,0,175,403,175,1006,0,-603
2017/7/14,臺指選擇權,CALL,外資及陸資,25138,70331,27808,82801,-2670,-12470,134894,847973,48093,295196,86801,552777
2017/7/14,臺指選擇權,PUT,自營商,95757,110163,79774,101786,15983,8377,162187,162373,133324,117181,28863,45192
2017/7/14,臺指選擇權,PUT,投信,0,0,0,0,0,0,175,4,175,4,0,0
2017/7/14,臺指選擇權,PUT,外資及陸資,24657,59259,21272,53188,3385,6071,230180,174911,42437,61582,187743,113329
2017/7/17,臺指選擇權,CALL,自營商,133543,262715,124652,247698,8891,15018,133291,459849,143794,689856,-10503,-230007
2017/7/17,臺指選擇權,CALL,投信,0,0,0,0,0,0,175,499,175,1225,0,-726
2017/7/17,臺指選擇權,CALL,外資及陸資,45069,130914,43910,135618,1159,-4704,136802,903122,48842,321759,87960,581363
2017/7/17,臺指選擇權,PUT,自營商,144498,179798,149348,173118,-4850,6680,169330,144296,145317,103705,24013,40591
2017/7/17,臺指選擇權,PUT,投信,0,0,0,0,0,0,175,3,175,4,0,-1
2017/7/17,臺指選擇權,PUT,外資及陸資,39078,89493,35331,85896,3747,3597,235222,160498,43732,54338,191490,106160
2017/7/18,臺指選擇權,CALL,自營商,98009,142514,94278,163122,3731,-20607,145233,491786,152004,779049,-6771,-287263
2017/7/18,臺指選擇權,CALL,投信,0,0,0,0,0,0,175,613,175,1435,0,-822
2017/7/18,臺指選擇權,CALL,外資及陸資,23891,76776,30423,90336,-6532,-13559,135480,951814,54056,358438,81424,593376
2017/7/18,臺指選擇權,PUT,自營商,109132,123357,113189,119184,-4057,4173,170754,123965,150798,96016,19956,27949
2017/7/18,臺指選擇權,PUT,投信,0,0,0,0,0,0,175,2,175,2,0,0
2017/7/18,臺指選擇權,PUT,外資及陸資,19683,49248,21655,56871,-1972,-7624,235703,143003,46186,54057,189517,88946
2017/7/19,臺指選擇權,CALL,自營商,241773,535825,204055,374018,37718,161807,68633,233131,56289,294749,12344,-61618
2017/7/19,臺指選擇權,CALL,投信,175,350,175,608,0,-258,175,276,175,516,0,-240
2017/7/19,臺指選擇權,CALL,外資及陸資,53052,174103,51168,166907,1884,7196,86269,685761,26861,212396,59408,473365
2017/7/19,臺指選擇權,PUT,自營商,217741,271759,290249,264374,-72508,7386,58126,87218,85156,84236,-27030,2982
2017/7/19,臺指選擇權,PUT,投信,175,286,175,421,0,-135,175,280,175,438,0,-158
2017/7/19,臺指選擇權,PUT,外資及陸資,46611,79224,38766,84901,7845,-5677,121440,133754,27717,59643,93723,74111
2017/7/20,臺指選擇權,CALL,自營商,78706,115993,80315,161319,-1609,-45326,79971,230751,69416,333401,10555,-102650
2017/7/20,臺指選擇權,CALL,投信,0,0,0,0,0,0,175,276,175,525,0,-249
2017/7/20,臺指選擇權,CALL,外資及陸資,26413,73530,23511,78176,2902,-4646,92572,704002,30082,227965,62490,476037
2017/7/20,臺指選擇權,PUT,自營商,120408,143805,93303,133711,27105,10093,94902,105181,94670,87825,232,17356
2017/7/20,臺指選擇權,PUT,投信,0,0,0,0,0,0,175,232,175,381,0,-149
2017/7/20,臺指選擇權,PUT,外資及陸資,41685,77899,23180,69590,18505,8309,141546,137196,29478,63163,112068,74033
2017/7/21,臺指選擇權,CALL,自營商,101108,139775,105163,170660,-4055,-30885,90837,192431,84337,298924,6500,-106493
2017/7/21,臺指選擇權,CALL,投信,0,0,0,0,0,0,175,166,175,341,0,-175
2017/7/21,臺指選擇權,CALL,外資及陸資,23958,72916,23535,76400,423,-3484,93633,605895,30722,192233,62911,413662
2017/7/21,臺指選擇權,PUT,自營商,115571,199401,94350,177626,21221,21775,120306,154789,98853,115269,21453,39520
2017/7/21,臺指選擇權,PUT,投信,0,0,0,0,0,0,175,302,175,508,0,-206
2017/7/21,臺指選擇權,PUT,外資及陸資,34117,110587,27656,93376,6461,17210,146723,168237,28194,72752,118529,95485
2017/7/24,臺指選擇權,CALL,自營商,119112,155602,100282,153216,18830,2386,110545,225024,85216,332550,25329,-107526
2017/7/24,臺指選擇權,CALL,投信,0,0,0,0,0,0,175,175,175,376,0,-201
2017/7/24,臺指選擇權,CALL,外資及陸資,25298,74491,25197,72826,101,1665,94725,636099,31713,207352,63012,428747
2017/7/24,臺指選擇權,PUT,自營商,122747,191972,132278,208732,-9531,-16760,125684,132543,113762,102631,11922,29912
2017/7/24,臺指選擇權,PUT,投信,0,0,0,0,0,0,175,228,175,381,0,-153
2017/7/24,臺指選擇權,PUT,外資及陸資,30550,85083,30299,88835,251,-3753,149375,148999,30595,66867,118780,82132
2017/7/25,臺指選擇權,CALL,自營商,98907,131148,106091,160944,-7184,-29796,112650,224016,94505,362641,18145,-138625
2017/7/25,臺指選擇權,CALL,投信,0,0,0,0,0,0,175,166,175,359,0,-193
2017/7/25,臺指選擇權,CALL,外資及陸資,31702,93692,31243,95474,459,-1782,96135,636710,32665,210211,63470,426499
2017/7/25,臺指選擇權,PUT,自營商,114861,161848,109528,146156,5333,15692,129519,138720,112264,93398,17255,45322
2017/7/25,臺指選擇權,PUT,投信,0,0,0,0,0,0,175,201,175,359,0,-158
2017/7/25,臺指選擇權,PUT,外資及陸資,29787,82959,28290,80770,1497,2189,150792,145772,30515,64943,120277,80829
2017/7/26,臺指選擇權,CALL,自營商,180661,271067,180421,253793,240,17273,85074,191617,82200,296274,2874,-104657
2017/7/26,臺指選擇權,CALL,投信,0,0,0,0,0,0,175,105,175,254,0,-149
2017/7/26,臺指選擇權,CALL,外資及陸資,45196,123113,43943,124809,1253,-1696,95342,565214,31334,182681,64008,382533
2017/7/26,臺指選擇權,PUT,自營商,207798,281864,211127,266650,-3329,15214,91968,163138,95191,104131,-3223,59007
2017/7/26,臺指選擇權,PUT,投信,0,0,0,0,0,0,175,223,175,398,0,-175
2017/7/26,臺指選擇權,PUT,外資及陸資,50411,113981,42262,109099,8149,4882,147614,161295,29729,72446,117885,88849
2017/7/27,臺指選擇權,CALL,自營商,158420,295992,131799,289013,26621,6979,111309,309141,81815,442223,29494,-133082
2017/7/27,臺指選擇權,CALL,投信,0,0,0,0,0,0,175,236,175,534,0,-298
2017/7/27,臺指選擇權,CALL,外資及陸資,38455,134121,33197,127012,5258,7109,100145,740181,30880,250542,69265,489639
2017/7/27,臺指選擇權,PUT,自營商,171028,221396,183122,290758,-12094,-69362,111375,107498,126693,114096,-15318,-6598
2017/7/27,臺指選擇權,PUT,投信,0,0,0,0,0,0,175,92,175,162,0,-70
2017/7/27,臺指選擇權,PUT,外資及陸資,38324,87810,32227,91533,6097,-3723,157983,116701,34001,52245,123982,64456
2017/7/28,臺指選擇權,CALL,自營商,114495,167183,141931,213388,-27436,-46205,106461,207915,104403,339587,2058,-131672
2017/7/28,臺指選擇權,CALL,投信,0,0,0,0,0,0,175,88,175,236,0,-148
2017/7/28,臺指選擇權,CALL,外資及陸資,37869,104604,34705,98933,3164,5671,102804,582110,30375,183851,72429,398259
2017/7/28,臺指選擇權,PUT,自營商,170436,337953,143285,222698,27151,115255,132303,249378,120470,134694,11833,114684
2017/7/28,臺指選擇權,PUT,投信,0,0,0,0,0,0,175,193,175,350,0,-157
2017/7/28,臺指選擇權,PUT,外資及陸資,70254,185784,43016,142823,27238,42961,182850,207041,31630,75154,151220,131887
2017/7/31,臺指選擇權,CALL,自營商,141534,179979,137967,190784,3567,-10805,115981,217684,110356,359103,5625,-141419
2017/7/31,臺指選擇權,CALL,投信,0,0,0,0,0,0,175,92,175,236,0,-144
2017/7/31,臺指選擇權,CALL,外資及陸資,36334,97240,33664,96960,2670,280,107349,601800,32253,196624,75096,405176
2017/7/31,臺指選擇權,PUT,自營商,131579,217487,149100,259191,-17521,-41703,131733,207927,137421,142381,-5688,65546
2017/7/31,臺指選擇權,PUT,投信,0,0,0,0,0,0,175,149,175,276,0,-127
2017/7/31,臺指選擇權,PUT,外資及陸資,49521,127133,40572,126880,8949,253,193399,192643,33231,74193,160168,118450
2017/8/1,臺指選擇權,CALL,自營商,140272,228083,134008,181534,6264,46549,113490,234525,101601,341791,11889,-107266
2017/8/1,臺指選擇權,CALL,投信,0,0,0,0,0,0,175,88,175,245,0,-157
2017/8/1,臺指選擇權,CALL,外資及陸資,38897,117491,36804,117106,2093,385,109204,615646,32015,202460,77189,413186
2017/8/1,臺指選擇權,PUT,自營商,157370,202516,168289,200432,-10919,2084,128560,213477,145168,146967,-16608,66510
2017/8/1,臺指選擇權,PUT,投信,0,0,0,0,0,0,175,136,175,245,0,-109
2017/8/1,臺指選擇權,PUT,外資及陸資,35617,82626,33478,82580,2139,46,197377,187832,35210,74004,162167,113828
2017/8/2,臺指選擇權,CALL,自營商,187831,351158,188799,318833,-968,32324,89001,276794,85883,393414,3118,-116620
2017/8/2,臺指選擇權,CALL,投信,0,0,0,0,0,0,175,175,175,446,0,-271
2017/8/2,臺指選擇權,CALL,外資及陸資,49671,141216,44200,139611,5471,1604,111709,743021,31887,259165,79822,483856
2017/8/2,臺指選擇權,PUT,自營商,177942,200591,218549,207840,-40607,-7249,92420,129929,124875,84296,-32455,45633
2017/8/2,臺指選擇權,PUT,投信,0,0,0,0,0,0,175,75,175,131,0,-56
2017/8/2,臺指選擇權,PUT,外資及陸資,38746,73199,32722,69862,6024,3337,187493,143702,33750,49083,153743,94619
2017/8/3,臺指選擇權,CALL,自營商,130799,246075,143784,308979,-12985,-62904,108163,265007,118030,455451,-9867,-190444
2017/8/3,臺指選擇權,CALL,投信,0,0,0,0,0,0,175,114,175,328,0,-214
2017/8/3,臺指選擇權,CALL,外資及陸資,40857,140171,45460,149196,-4603,-9026,114457,692994,39238,256112,75219,436882
2017/8/3,臺指選擇權,PUT,自營商,187256,294014,154793,249022,32463,44992,133492,202319,133484,110429,8,91890
2017/8/3,臺指選擇權,PUT,投信,0,0,0,0,0,0,175,114,175,201,0,-87
2017/8/3,臺指選擇權,PUT,外資及陸資,76240,196854,48321,181631,27919,15223,220839,253394,39177,116598,181662,136796
2017/8/4,臺指選擇權,CALL,自營商,72421,140980,69792,172591,2629,-31611,113323,291378,120561,544308,-7238,-252930
2017/8/4,臺指選擇權,CALL,投信,0,0,0,0,0,0,175,158,175,416,0,-258
2017/8/4,臺指選擇權,CALL,外資及陸資,26128,95082,27129,96776,-1001,-1694,116713,767929,42495,298286,74218,469643
2017/8/4,臺指選擇權,PUT,自營商,90292,125225,85651,147780,4641,-22555,145576,179891,140927,122971,4649,56920
2017/8/4,臺指選擇權,PUT,投信,0,0,0,0,0,0,175,85,175,144,0,-59
2017/8/4,臺指選擇權,PUT,外資及陸資,35622,125828,26718,102451,8904,23378,233580,295606,43015,138304,190565,157302
2017/8/7,臺指選擇權,CALL,自營商,126063,370685,117002,275560,9061,95125,112593,403127,110770,660303,1823,-257176
2017/8/7,臺指選擇權,CALL,投信,0,0,0,0,0,0,175,293,175,709,0,-416
2017/8/7,臺指選擇權,CALL,外資及陸資,41588,162425,37227,146318,4361,16107,121217,960777,42638,386778,78579,573999
2017/8/7,臺指選擇權,PUT,自營商,137232,187591,167293,189555,-30061,-1965,145101,151623,170513,121133,-25412,30490
2017/8/7,臺指選擇權,PUT,投信,0,0,0,0,0,0,175,39,175,58,0,-19
2017/8/7,臺指選擇權,PUT,外資及陸資,37168,111012,27543,82270,9625,28742,246318,267868,46128,118544,200190,149324
2017/8/8,臺指選擇權,CALL,自營商,151012,260177,165784,309671,-14772,-49494,115602,384905,128531,675357,-12929,-290452
2017/8/8,臺指選擇權,CALL,投信,0,0,0,0,0,0,175,254,175,683,0,-429
2017/8/8,臺指選擇權,CALL,外資及陸資,36759,120597,37968,128745,-1209,-8148,121847,938501,44495,385143,77352,553358
2017/8/8,臺指選擇權,PUT,自營商,176871,208981,171316,200497,5555,8484,151462,166330,171360,127298,-19898,39032
2017/8/8,臺指選擇權,PUT,投信,0,0,0,0,0,0,175,33,175,53,0,-20
2017/8/8,臺指選擇權,PUT,外資及陸資,47572,97507,33083,90287,14489,7221,261478,284084,46759,121450,214719,162634
2017/8/9,臺指選擇權,CALL,自營商,224083,272563,257531,342368,-33448,-69804,100584,288580,124753,527419,-24169,-238839
2017/8/9,臺指選擇權,CALL,投信,0,0,0,0,0,0,175,114,175,385,0,-271
2017/8/9,臺指選擇權,CALL,外資及陸資,52024,129172,53160,133809,-1136,-4637,120933,796803,45423,309295,75510,487508
2017/8/9,臺指選擇權,PUT,自營商,248356,381592,234853,350188,13503,31404,123045,253151,145285,159975,-22240,93176
2017/8/9,臺指選擇權,PUT,投信,0,0,0,0,0,0,175,50,175,92,0,-42
2017/8/9,臺指選擇權,PUT,外資及陸資,85120,191872,60371,161744,24749,30128,261795,388817,42340,151270,219455,237547
2017/8/10,臺指選擇權,CALL,自營商,228389,306108,227266,336365,1123,-30257,117511,208586,140557,369011,-23046,-160425
2017/8/10,臺指選擇權,CALL,投信,0,0,0,0,0,0,175,18,175,79,0,-61
2017/8/10,臺指選擇權,CALL,外資及陸資,57757,151940,62079,167820,-4322,-15880,122487,616533,51299,222099,71188,394434
2017/8/10,臺指選擇權,PUT,自營商,225483,450977,248160,560781,-22677,-109804,130314,409818,175231,335408,-44917,74410
2017/8/10,臺指選擇權,PUT,投信,210,735,0,0,210,735,385,863,175,206,210,657
2017/8/10,臺指選擇權,PUT,外資及陸資,152835,306324,79490,295800,73345,10524,336968,616259,44124,236242,292844,380017
2017/8/11,臺指選擇權,CALL,自營商,178092,281108,177632,274245,460,6863,120766,210109,143352,335132,-22586,-125023
2017/8/11,臺指選擇權,CALL,投信,0,0,0,0,0,0,175,10,175,27,0,-17
2017/8/11,臺指選擇權,CALL,外資及陸資,53892,161466,47833,140709,6059,20757,128207,610414,50960,206920,77247,403494
2017/8/11,臺指選擇權,PUT,自營商,208174,448090,217225,540819,-9051,-92730,146316,438388,200284,438681,-53968,-293
2017/8/11,臺指選擇權,PUT,投信,0,0,0,0,0,0,385,956,175,232,210,724
2017/8/11,臺指選擇權,PUT,外資及陸資,105845,275807,65275,237610,40570,38196,378263,767317,44849,272027,333414,495290
2017/8/14,臺指選擇權,CALL,自營商,181638,255687,192363,272917,-10725,-17230,129325,168444,162660,262856,-33335,-94412
2017/8/14,臺指選擇權,CALL,投信,0,0,0,0,0,0,175,5,175,11,0,-6
2017/8/14,臺指選擇權,CALL,外資及陸資,55981,153040,57097,153964,-1116,-923,128504,498913,52353,155903,76151,343010
2017/8/14,臺指選擇權,PUT,自營商,181240,371248,184288,388067,-3048,-16819,151639,534466,208669,532937,-57030,1529
2017/8/14,臺指選擇權,PUT,投信,1200,958,0,0,1200,958,1585,3271,175,271,1410,3000
2017/8/14,臺指選擇權,PUT,外資及陸資,74651,237494,78387,268055,-3736,-30561,376677,885097,46999,350850,329678,534247
2017/8/15,臺指選擇權,CALL,自營商,157304,216926,158958,254497,-1654,-37571,125500,196137,160492,329864,-34992,-133727
2017/8/15,臺指選擇權,CALL,投信,0,0,0,0,0,0,175,3,175,8,0,-5
2017/8/15,臺指選擇權,CALL,外資及陸資,49720,134308,54324,139474,-4604,-5167,130035,568079,58489,192666,71546,375413
2017/8/15,臺指選擇權,PUT,自營商,188100,305696,187601,311688,499,-5992,165200,377628,221731,411163,-56531,-33535
2017/8/15,臺指選擇權,PUT,投信,1200,1970,1410,1128,-210,842,1375,1417,175,35,1200,1382
2017/8/15,臺指選擇權,PUT,外資及陸資,58804,123518,64402,167507,-5598,-43990,375817,622566,51719,294637,324098,327929
2017/8/16,臺指選擇權,CALL,自營商,227018,291632,252098,350604,-25080,-58972,69135,128225,72624,258746,-3489,-130521
2017/8/16,臺指選擇權,CALL,投信,175,201,175,358,0,-158,175,179,175,346,0,-167
2017/8/16,臺指選擇權,CALL,外資及陸資,62567,151582,64943,158285,-2376,-6703,97308,504961,30716,170778,66592,334183
2017/8/16,臺指選擇權,PUT,自營商,304444,416406,311315,429304,-6871,-12898,94763,230117,146491,331134,-51728,-101017
2017/8/16,臺指選擇權,PUT,投信,175,455,175,620,0,-165,175,455,175,630,0,-175
2017/8/16,臺指選擇權,PUT,外資及陸資,94614,201315,94030,212997,584,-11682,194983,582936,42068,286486,152915,296450
2017/8/17,臺指選擇權,CALL,自營商,117129,221643,93218,216978,23911,4665,101055,184518,80644,334447,20411,-149929
2017/8/17,臺指選擇權,CALL,投信,0,0,0,0,0,0,175,232,175,446,0,-214
2017/8/17,臺指選擇權,CALL,外資及陸資,38827,128484,32084,123596,6743,4888,104977,587581,31631,208857,73346,378724
2017/8/17,臺指選擇權,PUT,自營商,190808,227205,167904,264511,22904,-37306,141956,200585,170740,318228,-28784,-117643
2017/8/17,臺指選擇權,PUT,投信,0,0,0,0,0,0,175,298,175,433,0,-135
2017/8/17,臺指選擇權,PUT,外資及陸資,48013,100698,33053,114095,14960,-13397,212829,467298,44994,246431,167835,220867
2017/8/18,臺指選擇權,CALL,自營商,133181,264829,143788,297343,-10607,-32514,114765,196611,104961,374848,9804,-178237
2017/8/18,臺指選擇權,CALL,投信,0,0,0,0,0,0,175,184,175,368,0,-184
2017/8/18,臺指選擇權,CALL,外資及陸資,39054,133205,36759,128636,2295,4569,107626,546340,31985,191922,75641,354418
2017/8/18,臺指選擇權,PUT,自營商,168950,343294,148579,308324,20371,34970,166990,274664,175423,378607,-8433,-103943
2017/8/18,臺指選擇權,PUT,投信,0,0,0,0,0,0,175,389,175,551,0,-162
2017/8/18,臺指選擇權,PUT,外資及陸資,58566,192322,42555,145889,16011,46433,228258,567774,44392,274755,183866,293019
2017/8/21,臺指選擇權,CALL,自營商,103616,182058,101315,170372,2301,11686,118298,213155,106162,385318,12136,-172163
2017/8/21,臺指選擇權,CALL,投信,0,0,0,0,0,0,175,171,175,359,0,-188
2017/8/21,臺指選擇權,CALL,外資及陸資,32121,101111,32279,103115,-158,-2004,108435,548958,32983,197307,75452,351651
2017/8/21,臺指選擇權,PUT,自營商,119050,186034,122522,199322,-3472,-13289,174074,269953,185979,379183,-11905,-109230
2017/8/21,臺指選擇權,PUT,投信,0,0,0,0,0,0,175,359,175,508,0,-149
2017/8/21,臺指選擇權,PUT,外資及陸資,36006,109935,34740,105510,1266,4425,230814,545066,45682,265887,185132,279179
2017/8/22,臺指選擇權,CALL,自營商,130287,349206,109622,202112,20665,147095,137740,362468,104958,433853,32782,-71385
2017/8/22,臺指選擇權,CALL,投信,0,0,0,0,0,0,175,241,175,481,0,-240
2017/8/22,臺指選擇權,CALL,外資及陸資,45231,151794,34573,133943,10658,17851,118078,660325,31949,238996,86129,421329
2017/8/22,臺指選擇權,PUT,自營商,149531,217587,175703,248823,-26172,-31236,185460,227261,223537,345396,-38077,-118135
2017/8/22,臺指選擇權,PUT,投信,0,0,0,0,0,0,175,219,175,306,0,-87
2017/8/22,臺指選擇權,PUT,外資及陸資,39584,103299,38943,110817,641,-7518,237669,448004,51896,227981,185773,220023
2017/8/23,臺指選擇權,CALL,自營商,191855,338013,205050,379172,-13195,-41159,105586,239756,81933,334982,23653,-95226
2017/8/23,臺指選擇權,CALL,投信,0,0,0,0,0,0,175,232,175,481,0,-249
2017/8/23,臺指選擇權,CALL,外資及陸資,49458,154820,47435,147049,2023,7771,114515,646111,30138,225553,84377,420558
2017/8/23,臺指選擇權,PUT,自營商,240924,318892,252977,320443,-12053,-1551,119386,191174,180497,314244,-61111,-123070
2017/8/23,臺指選擇權,PUT,投信,0,0,0,0,0,0,175,179,175,258,0,-79
2017/8/23,臺指選擇權,PUT,外資及陸資,53788,126821,43863,110207,9925,16614,229960,434895,50588,215221,179372,219674
2017/8/24,臺指選擇權,CALL,自營商,130396,255672,115280,227001,15116,28671,122919,358638,84150,416360,38769,-57722
2017/8/24,臺指選擇權,CALL,投信,0,0,0,0,0,0,175,381,175,726,0,-345
2017/8/24,臺指選擇權,CALL,外資及陸資,34498,113364,24972,92369,9526,20995,124218,811707,30315,280344,93903,531363
2017/8/24,臺指選擇權,PUT,自營商,160578,210601,168604,249200,-8026,-38599,139413,152559,208550,272541,-69137,-119982
2017/8/24,臺指選擇權,PUT,投信,0,0,0,0,0,0,175,114,175,166,0,-52
2017/8/24,臺指選擇權,PUT,外資及陸資,41194,83659,29659,84358,11535,-699,246003,356461,55096,174783,190907,181678
2017/8/25,臺指選擇權,CALL,自營商,128504,275554,140868,310679,-12364,-35125,118738,392209,92333,481110,26405,-88901
2017/8/25,臺指選擇權,CALL,投信,0,0,0,0,0,0,175,481,175,884,0,-403
2017/8/25,臺指選擇權,CALL,外資及陸資,37746,126888,32942,116521,4804,10367,130088,901242,31381,308409,98707,592833
2017/8/25,臺指選擇權,PUT,自營商,176890,246171,164773,222736,12117,23434,163285,176590,220305,256891,-57020,-80301
2017/8/25,臺指選擇權,PUT,投信,0,0,0,0,0,0,175,96,175,131,0,-35
2017/8/25,臺指選擇權,PUT,外資及陸資,47528,115677,35081,92192,12447,23486,261714,352888,58360,160427,203354,192461
2017/8/28,臺指選擇權,CALL,自營商,106318,195973,111126,212298,-4808,-16324,122925,395091,101328,503839,21597,-108748
2017/8/28,臺指選擇權,CALL,投信,0,0,0,0,0,0,175,481,175,875,0,-394
2017/8/28,臺指選擇權,CALL,外資及陸資,35244,112584,32849,111727,2395,857,134159,926991,33057,318667,101102,608324
2017/8/28,臺指選擇權,PUT,自營商,113403,154345,121330,207510,-7927,-53164,160071,170199,224964,302809,-64893,-132610
2017/8/28,臺指選擇權,PUT,投信,0,0,0,0,0,0,175,88,175,127,0,-39
2017/8/28,臺指選擇權,PUT,外資及陸資,45148,198548,38405,154935,6743,43613,274254,463302,64231,223673,210023,239629
2017/8/29,臺指選擇權,CALL,自營商,127243,213206,123454,219564,3789,-6357,131313,373358,105927,476655,25386,-103297
2017/8/29,臺指選擇權,CALL,投信,0,0,0,0,0,0,175,433,175,805,0,-372
2017/8/29,臺指選擇權,CALL,外資及陸資,36131,111758,36563,116449,-432,-4691,134681,883315,34011,305353,100670,577962
2017/8/29,臺指選擇權,PUT,自營商,158235,242249,143723,230182,14512,12067,178940,217083,229321,354116,-50381,-137033
2017/8/29,臺指選擇權,PUT,投信,0,0,0,0,0,0,175,127,175,175,0,-48
2017/8/29,臺指選擇權,PUT,外資及陸資,45433,121257,37061,104195,8372,17062,280454,527472,62059,247035,218395,280437
2017/8/30,臺指選擇權,CALL,自營商,212313,393652,205264,368793,7049,24859,113069,425397,89803,519732,23266,-94335
2017/8/30,臺指選擇權,CALL,投信,0,0,0,0,0,0,175,586,175,1050,0,-464
2017/8/30,臺指選擇權,CALL,外資及陸資,61700,182407,49714,158934,11986,23473,139337,1015434,31115,346011,108222,669423
2017/8/30,臺指選擇權,PUT,自營商,217446,262320,257192,322162,-39746,-59842,122766,165095,219664,343063,-96898,-177968
2017/8/30,臺指選擇權,PUT,投信,0,0,0,0,0,0,175,81,175,109,0,-28
2017/8/30,臺指選擇權,PUT,外資及陸資,58274,185838,50544,133095,7730,52744,281345,518784,64980,222846,216365,295938
2017/8/31,臺指選擇權,CALL,自營商,111269,212777,109395,253254,1874,-40477,121814,431024,96674,564110,25140,-133086
2017/8/31,臺指選擇權,CALL,投信,0,0,0,0,0,0,175,639,175,1138,0,-499
2017/8/31,臺指選擇權,CALL,外資及陸資,32582,115082,29622,112460,2960,2621,143171,1063053,31989,362503,111182,700550
2017/8/31,臺指選擇權,PUT,自營商,135481,194945,134657,201161,824,-6216,146981,188920,243075,368513,-96094,-179593
2017/8/31,臺指選擇權,PUT,投信,0,0,0,0,0,0,175,78,175,105,0,-27
2017/8/31,臺指選擇權,PUT,外資及陸資,36136,109474,30992,95976,5144,13498,289903,521237,68374,221786,221529,299451
2017/9/1,臺指選擇權,CALL,自營商,100625,215414,88470,193662,12155,21752,134190,479096,96895,597174,37295,-118078
2017/9/1,臺指選擇權,CALL,投信,0,0,0,0,0,0,175,700,175,1243,0,-543
2017/9/1,臺指選擇權,CALL,外資及陸資,23143,83653,20080,77213,3063,6440,146288,1121245,32043,381048,114245,740197
2017/9/1,臺指選擇權,PUT,自營商,115158,149451,131310,192629,-16152,-43178,146852,158997,259098,367761,-112246,-208764
2017/9/1,臺指選擇權,PUT,投信,0,0,0,0,0,0,175,66,175,92,0,-26
2017/9/1,臺指選擇權,PUT,外資及陸資,29681,79161,25016,68498,4665,10663,296703,496627,70518,206473,226185,290154
2017/9/4,臺指選擇權,CALL,自營商,81694,137755,79008,142952,2686,-5198,138444,437741,98463,564349,39981,-126608
2017/9/4,臺指選擇權,CALL,投信,0,0,0,0,0,0,175,613,175,1120,0,-507
2017/9/4,臺指選擇權,CALL,外資及陸資,24102,82031,24289,86428,-187,-4397,146114,1059303,32056,361077,114058,698226
2017/9/4,臺指選擇權,PUT,自營商,111476,162281,111880,169860,-404,-7579,148337,175990,260987,404199,-112650,-228209
2017/9/4,臺指選擇權,PUT,投信,0,0,0,0,0,0,175,71,175,96,0,-25
2017/9/4,臺指選擇權,PUT,外資及陸資,33287,92686,27439,79500,5848,13186,302285,539216,70252,221211,232033,318005
2017/9/5,臺指選擇權,CALL,自營商,98120,174528,111891,197814,-13771,-23286,131197,477893,104987,631061,26210,-153168
2017/9/5,臺指選擇權,CALL,投信,0,0,0,0,0,0,175,718,175,1278,0,-560
2017/9/5,臺指選擇權,CALL,外資及陸資,25286,83370,27827,92468,-2541,-9098,145402,1131362,33885,395867,111517,735495
2017/9/5,臺指選擇權,PUT,自營商,148462,181953,121835,151087,26627,30866,163292,172336,249315,360665,-86023,-188329
2017/9/5,臺指選擇權,PUT,投信,0,0,0,0,0,0,175,64,175,83,0,-19
2017/9/5,臺指選擇權,PUT,外資及陸資,33174,89082,29192,77136,3982,11946,307825,515812,71810,204962,236015,310850
2017/9/6,臺指選擇權,CALL,自營商,207723,304751,214371,352433,-6648,-47682,119335,373056,92608,550242,26727,-177186
2017/9/6,臺指選擇權,CALL,投信,0,0,0,0,0,0,175,464,175,910,0,-446
2017/9/6,臺指選擇權,CALL,外資及陸資,50845,136507,48847,130955,1998,5552,146276,980691,32657,334921,113619,645770
2017/9/6,臺指選擇權,PUT,自營商,248457,330807,226100,322003,22357,8804,151080,217258,236766,437237,-85686,-219979
2017/9/6,臺指選擇權,PUT,投信,0,0,0,0,0,0,175,74,175,101,0,-27
2017/9/6,臺指選擇權,PUT,外資及陸資,64045,158005,50159,127916,13886,30089,315288,626436,70182,243702,245106,382734
2017/9/7,臺指選擇權,CALL,自營商,140446,252394,138413,268160,2033,-15766,143593,353643,114833,529066,28760,-175423
2017/9/7,臺指選擇權,CALL,投信,0,0,0,0,0,0,175,341,175,744,0,-403
2017/9/7,臺指選擇權,CALL,外資及陸資,30686,107289,31672,115552,-986,-8263,148470,905321,35837,316131,112633,589190
2017/9/7,臺指選擇權,PUT,自營商,153266,280829,160050,324348,-6784,-43518,171506,271499,264016,561617,-92510,-290118
2017/9/7,臺指選擇權,PUT,投信,0,0,0,0,0,0,175,74,175,96,0,-22
2017/9/7,臺指選擇權,PUT,外資及陸資,39867,121635,33666,113325,6201,8310,324483,670198,73136,263807,251347,406391
2017/9/8,臺指選擇權,CALL,自營商,119291,227687,107424,209073,11867,18615,155575,462425,114948,633251,40627,-170826
2017/9/8,臺指選擇權,CALL,投信,0,0,0,0,0,0,175,551,175,1059,0,-508
2017/9/8,臺指選擇權,CALL,外資及陸資,31053,110495,28955,100852,2098,9643,149768,1050567,35037,367984,114731,682583
2017/9/8,臺指選擇權,PUT,自營商,168364,273574,185618,316196,-17254,-42622,187653,229273,297384,502832,-109731,-273559
2017/9/8,臺指選擇權,PUT,投信,0,0,0,0,0,0,175,59,175,76,0,-17
2017/9/8,臺指選擇權,PUT,外資及陸資,49222,132321,43598,136332,5624,-4010,337261,610583,80324,245387,256937,365196
2017/9/11,臺指選擇權,CALL,自營商,150298,314238,168352,354789,-18054,-40551,142944,425619,120371,635490,22573,-209871
2017/9/11,臺指選擇權,CALL,投信,0,0,0,0,0,0,175,490,175,1024,0,-534
2017/9/11,臺指選擇權,CALL,外資及陸資,44324,139255,53452,167943,-9128,-28688,145085,1035038,39482,385222,105603,649816
2017/9/11,臺指選擇權,PUT,自營商,219391,341214,194292,286929,25099,54285,203811,245214,288443,417812,-84632,-172598
2017/9/11,臺指選擇權,PUT,投信,0,0,0,0,0,0,175,33,175,46,0,-13
2017/9/11,臺指選擇權,PUT,外資及陸資,54182,140337,46839,142050,7343,-1713,345091,549240,80811,228434,264280,320806
2017/9/12,臺指選擇權,CALL,自營商,118084,212708,116406,189993,1678,22715,147299,453733,123048,650041,24251,-196308
2017/9/12,臺指選擇權,CALL,投信,0,0,0,0,0,0,175,525,175,1076,0,-551
2017/9/12,臺指選擇權,CALL,外資及陸資,40715,117150,33853,108057,6862,9093,150435,1071396,37970,394487,112465,676909
2017/9/12,臺指選擇權,PUT,自營商,179785,222122,176340,208309,3445,13814,221421,220885,302628,360663,-81207,-139778
2017/9/12,臺指選擇權,PUT,投信,0,0,0,0,0,0,175,17,175,23,0,-6
2017/9/12,臺指選擇權,PUT,外資及陸資,46932,107896,43717,111842,3215,-3947,355519,483071,88004,211042,267515,272029
2017/9/13,臺指選擇權,CALL,自營商,184793,213281,214557,251990,-29764,-38709,116919,301793,112731,513775,4188,-211982
2017/9/13,臺指選擇權,CALL,投信,0,0,0,0,0,0,175,214,175,613,0,-399
2017/9/13,臺指選擇權,CALL,外資及陸資,46569,117853,43146,113849,3423,4004,146295,864787,34903,306105,111392,558682
2017/9/13,臺指選擇權,PUT,自營商,239689,308621,228183,310527,11506,-1906,173623,232461,262489,391991,-88866,-159530
2017/9/13,臺指選擇權,PUT,投信,0,0,0,0,0,0,175,11,175,18,0,-7
2017/9/13,臺指選擇權,PUT,外資及陸資,68368,156260,53258,133412,15110,22849,360824,541955,82909,232606,277915,309349
2017/9/14,臺指選擇權,CALL,自營商,98177,140282,91574,133067,6603,7215,130086,318226,119305,525968,10781,-207742
2017/9/14,臺指選擇權,CALL,投信,0,0,427,551,-427,-551,175,197,602,1157,-427,-960
2017/9/14,臺指選擇權,CALL,外資及陸資,25642,80137,24283,82460,1359,-2324,149417,867241,36666,316597,112751,550644
2017/9/14,臺指選擇權,PUT,自營商,102673,145658,118165,183470,-15492,-37812,177283,207826,281641,388440,-104358,-180614
2017/9/14,臺指選擇權,PUT,投信,0,0,448,1497,-448,-1497,175,9,623,1535,-448,-1526
2017/9/14,臺指選擇權,PUT,外資及陸資,35851,87034,28259,88879,7592,-1845,369748,498413,84251,219122,285497,279291
2017/9/15,臺指選擇權,CALL,自營商,138622,183640,151319,188592,-12697,-4952,129359,354381,131275,583781,-1916,-229400
2017/9/15,臺指選擇權,CALL,投信,0,0,0,0,0,0,175,219,602,1404,-427,-1185
2017/9/15,臺指選擇權,CALL,外資及陸資,27809,95833,26895,86318,914,9516,152993,961622,39328,360958,113665,600664
2017/9/15,臺指選擇權,PUT,自營商,141499,203363,136042,190596,5457,12767,185355,177155,284256,325015,-98901,-147860
2017/9/15,臺指選擇權,PUT,投信,0,0,0,0,0,0,175,5,623,1240,-448,-1235
2017/9/15,臺指選擇權,PUT,外資及陸資,34760,92728,27848,78317,6912,14412,379713,440792,87304,184735,292409,256057
2017/9/18,臺指選擇權,CALL,自營商,146243,301966,131257,258973,14986,42993,136047,481289,122977,692432,13070,-211143
2017/9/18,臺指選擇權,CALL,投信,0,0,0,0,0,0,175,455,602,2207,-427,-1752
2017/9/18,臺指選擇權,CALL,外資及陸資,43639,140718,40673,135632,2966,5087,155246,1131569,38611,436239,116635,695330
2017/9/18,臺指選擇權,PUT,自營商,163536,193768,175308,204774,-11772,-11006,197453,151483,308126,284382,-110673,-132899
2017/9/18,臺指選擇權,PUT,投信,0,0,0,0,0,0,175,4,623,856,-448,-852
2017/9/18,臺指選擇權,PUT,外資及陸資,34569,87713,30208,78827,4361,8886,385334,357896,88564,146597,296770,211299
2017/9/19,臺指選擇權,CALL,自營商,133795,197601,174097,318657,-40302,-121056,125163,342548,152395,624370,-27232,-281822
2017/9/19,臺指選擇權,CALL,投信,0,0,0,0,0,0,175,109,602,1337,-427,-1228
2017/9/19,臺指選擇權,CALL,外資及陸資,44567,119235,35695,105103,8872,14132,165116,986523,39609,365669,125507,620854
2017/9/19,臺指選擇權,PUT,自營商,207254,263930,163522,221231,43732,42699,233309,280443,300250,346453,-66941,-66010
2017/9/19,臺指選擇權,PUT,投信,0,0,0,0,0,0,175,2,623,1055,-448,-1053
2017/9/19,臺指選擇權,PUT,外資及陸資,49844,117884,43580,98236,6264,19647,394827,453726,91793,190064,303034,263662
2017/9/20,臺指選擇權,CALL,自營商,252261,312696,295612,395794,-43351,-83098,67907,167106,56216,222904,11691,-55798
2017/9/20,臺指選擇權,CALL,投信,210,226,426,476,-216,-250,210,210,853,907,-643,-697
2017/9/20,臺指選擇權,CALL,外資及陸資,49437,146419,45797,135103,3640,11316,86640,459179,16257,122068,70383,337111
2017/9/20,臺指選擇權,PUT,自營商,290770,453658,315982,521183,-25212,-67525,102172,188966,163417,346235,-61245,-157269
2017/9/20,臺指選擇權,PUT,投信,210,247,435,443,-225,-196,210,257,883,1648,-673,-1391
2017/9/20,臺指選擇權,PUT,外資及陸資,84316,228051,72085,212708,12231,15343,216231,520710,52283,214468,163948,306242
2017/9/21,臺指選擇權,CALL,自營商,143840,248688,116408,218133,27432,30555,105263,253816,66140,283836,39123,-30020
2017/9/21,臺指選擇權,CALL,投信,0,0,0,0,0,0,210,252,853,1061,-643,-809
2017/9/21,臺指選擇權,CALL,外資及陸資,39975,128918,32427,117918,7548,11001,95500,528343,17569,149119,77931,379224
2017/9/21,臺指選擇權,PUT,自營商,141088,248691,144302,244020,-3214,4671,122328,176772,186787,293231,-64459,-116459
2017/9/21,臺指選擇權,PUT,投信,0,0,0,0,0,0,210,152,883,1016,-673,-864
2017/9/21,臺指選擇權,PUT,外資及陸資,52220,136376,38192,115268,14028,21108,231151,426067,53175,169052,177976,257015
2017/9/22,臺指選擇權,CALL,自營商,171887,256631,190707,269827,-18820,-13196,108942,169011,88639,207730,20303,-38719
2017/9/22,臺指選擇權,CALL,投信,0,0,0,0,0,0,210,92,853,401,-643,-309
2017/9/22,臺指選擇權,CALL,外資及陸資,45183,115190,39528,117158,5655,-1968,102540,374749,18954,107517,83586,267232
2017/9/22,臺指選擇權,PUT,自營商,214735,438088,186712,380881,28023,57207,151465,392096,187911,496376,-36446,-104280
2017/9/22,臺指選擇權,PUT,投信,0,0,0,0,0,0,210,331,883,2159,-673,-1828
2017/9/22,臺指選擇權,PUT,外資及陸資,73321,229748,53359,181074,19962,48674,251281,726403,53343,281129,197938,445274
2017/9/25,臺指選擇權,CALL,自營商,234102,313735,262358,319887,-28256,-6152,111935,154578,119887,180152,-7952,-25574
2017/9/25,臺指選擇權,CALL,投信,427,103,0,0,427,103,210,44,426,98,-216,-54
2017/9/25,臺指選擇權,CALL,外資及陸資,55642,140187,56575,143151,-933,-2963,105362,299043,22709,90356,82653,208687
2017/9/25,臺指選擇權,PUT,自營商,235161,558893,237480,551791,-2319,7102,167244,578214,206009,696465,-38765,-118251
2017/9/25,臺指選擇權,PUT,投信,36,37,0,0,36,37,210,499,847,3231,-637,-2732
2017/9/25,臺指選擇權,PUT,外資及陸資,87382,296912,80093,294669,7289,2243,261094,973298,55869,389200,205225,584098
2017/9/26,臺指選擇權,CALL,自營商,234867,325971,245259,286049,-10392,39922,129942,145735,148285,143587,-18343,2148
2017/9/26,臺指選擇權,CALL,投信,0,0,0,0,0,0,210,32,426,56,-216,-24
2017/9/26,臺指選擇權,CALL,外資及陸資,51950,124399,45564,112596,6386,11803,111703,248131,22664,71822,89039,176309
2017/9/26,臺指選擇權,PUT,自營商,248347,496936,244237,513427,4110,-16492,178284,727752,212939,890864,-34655,-163112
2017/9/26,臺指選擇權,PUT,投信,0,0,0,0,0,0,210,609,847,4181,-637,-3572
2017/9/26,臺指選擇權,PUT,外資及陸資,69323,193814,64295,183625,5028,10188,268324,1173796,58071,474582,210253,699214
2017/9/27,臺指選擇權,CALL,自營商,235057,348204,236999,386879,-1942,-38675,106596,183171,100179,205185,6417,-22014
2017/9/27,臺指選擇權,CALL,投信,216,2,215,25,1,-23,210,27,425,87,-215,-60
2017/9/27,臺指選擇權,CALL,外資及陸資,57825,163086,53997,150331,3828,12755,104330,280543,20447,80712,83883,199831
2017/9/27,臺指選擇權,PUT,自營商,223218,332270,247991,362916,-24773,-30646,129244,334604,187114,554991,-57870,-220387
2017/9/27,臺指選擇權,PUT,投信,189,3,192,69,-3,-66,210,404,850,2838,-640,-2434
2017/9/27,臺指選擇權,PUT,外資及陸資,64675,153561,59388,147300,5287,6261,262930,903871,53078,367783,209852,536088
2017/9/28,臺指選擇權,CALL,自營商,149837,230602,140377,254021,9460,-23419,133512,177944,117635,217329,15877,-39385
2017/9/28,臺指選擇權,CALL,投信,0,0,210,96,-210,-96,210,20,635,143,-425,-123
2017/9/28,臺指選擇權,CALL,外資及陸資,38032,105349,35832,107947,2200,-2599,108940,263275,22857,80087,86083,183188
2017/9/28,臺指選擇權,PUT,自營商,142742,261323,132569,258568,10173,2755,152455,353934,200152,577758,-47697,-223824
2017/9/28,臺指選擇權,PUT,投信,0,0,0,0,0,0,210,399,850,2903,-640,-2504
2017/9/28,臺指選擇權,PUT,外資及陸資,48886,132246,38619,122452,10267,9795,272655,918535,52536,375589,220119,542946
2017/9/29,臺指選擇權,CALL,自營商,126517,188525,111160,181012,15357,7513,153435,200037,122201,230585,31234,-30548
2017/9/29,臺指選擇權,CALL,投信,0,0,0,0,0,0,210,13,635,110,-425,-97
2017/9/29,臺指選擇權,CALL,外資及陸資,33498,90135,27254,80966,6244,9170,115125,268315,22798,79010,92327,189305
2017/9/29,臺指選擇權,PUT,自營商,108529,211013,115937,230603,-7408,-19589,153981,316288,209086,541977,-55105,-225689
2017/9/29,臺指選擇權,PUT,投信,0,0,0,0,0,0,210,299,850,2348,-640,-2049
2017/9/29,臺指選擇權,PUT,外資及陸資,40068,109549,33085,100302,6983,9247,279289,841770,52187,343902,227102,497868
2017/9/30,臺指選擇權,CALL,自營商,77476,144229,74225,126101,3251,18127,155934,260046,121449,277255,34485,-17209
2017/9/30,臺指選擇權,CALL,投信,0,0,0,0,0,0,210,16,635,149,-425,-133
2017/9/30,臺指選擇權,CALL,外資及陸資,15925,42492,9958,33922,5967,8570,119395,308099,21101,90566,98294,217533
2017/9/30,臺指選擇權,PUT,自營商,98145,137585,101952,122637,-3807,14948,157722,252382,216634,406478,-58912,-154096
2017/9/30,臺指選擇權,PUT,投信,0,0,0,0,0,0,210,158,850,1386,-640,-1228
2017/9/30,臺指選擇權,PUT,外資及陸資,12622,29087,9392,22901,3230,6187,281986,631304,51654,261424,230332,369880
2017/10/2,臺指選擇權,CALL,自營商,138569,272820,135993,249866,2576,22954,157975,381991,120914,353649,37061,28342
2017/10/2,臺指選擇權,CALL,投信,0,0,0,0,0,0,210,21,635,284,-425,-263
2017/10/2,臺指選擇權,CALL,外資及陸資,49119,118128,30456,105055,18663,13073,135651,388812,18694,112344,116957,276468
2017/10/2,臺指選擇權,PUT,自營商,162781,216739,169956,198115,-7175,18625,157983,203473,224070,301111,-66087,-97638
2017/10/2,臺指選擇權,PUT,投信,0,0,0,0,0,0,210,87,850,761,-640,-674
2017/10/2,臺指選擇權,PUT,外資及陸資,34197,71471,27656,62712,6541,8758,288519,475809,51646,191631,236873,284178
2017/10/3,臺指選擇權,CALL,自營商,120294,198617,128903,243752,-8609,-45135,159013,375545,130561,393304,28452,-17759
2017/10/3,臺指選擇權,CALL,投信,0,0,0,0,0,0,210,18,635,250,-425,-232
2017/10/3,臺指選擇權,CALL,外資及陸資,38033,107135,35269,101438,2764,5696,138514,397939,18793,115312,119721,282627
2017/10/3,臺指選擇權,PUT,自營商,156746,179882,142736,166275,14010,13608,178267,195662,230344,275612,-52077,-79950
2017/10/3,臺指選擇權,PUT,投信,0,0,0,0,0,0,210,62,850,587,-640,-525
2017/10/3,臺指選擇權,PUT,外資及陸資,37452,90345,37050,82244,402,8101,289945,439053,52670,174339,237275,264714
2017/10/5,臺指選擇權,CALL,自營商,184461,334403,179595,333163,4866,1241,107904,285284,99322,335277,8582,-49993
2017/10/5,臺指選擇權,CALL,投信,215,5,210,4,5,1,210,25,630,340,-420,-315
2017/10/5,臺指選擇權,CALL,外資及陸資,48851,143582,44375,126219,4476,17363,135242,444169,17333,108501,117909,335668
2017/10/5,臺指選擇權,PUT,自營商,174118,176331,211381,187087,-37263,-10755,127174,151043,200135,224865,-72961,-73822
2017/10/5,臺指選擇權,PUT,投信,192,2,188,23,4,-21,210,48,846,419,-636,-371
2017/10/5,臺指選擇權,PUT,外資及陸資,40771,77827,34757,66105,6014,11722,286022,370802,50993,133169,235029,237633
2017/10/6,臺指選擇權,CALL,自營商,132992,181352,114171,207673,18821,-26321,130159,290072,102756,364522,27403,-74450
2017/10/6,臺指選擇權,CALL,投信,0,0,0,0,0,0,210,18,630,354,-420,-336
2017/10/6,臺指選擇權,CALL,外資及陸資,31703,86514,29338,80758,2365,5756,138077,478070,17803,118557,120274,359513
2017/10/6,臺指選擇權,PUT,自營商,160424,167185,127916,154927,32508,12258,160633,153595,201086,210183,-40453,-56588
2017/10/6,臺指選擇權,PUT,投信,0,0,0,0,0,0,210,34,846,284,-636,-250
2017/10/6,臺指選擇權,PUT,外資及陸資,29156,66641,24556,59559,4600,7081,292756,351408,53147,121944,239609,229464
2017/10/11,臺指選擇權,CALL,自營商,296120,555103,287088,541442,9032,13661,115949,433768,90714,501872,25235,-68104
2017/10/11,臺指選擇權,CALL,投信,210,2,207,6,3,-4,210,29,627,883,-417,-854
2017/10/11,臺指選擇權,CALL,外資及陸資,85366,244020,74443,223428,10923,20592,149992,668721,21200,165304,128792,503417
2017/10/11,臺指選擇權,PUT,自營商,280446,293049,308892,286524,-28446,6525,142619,117637,210655,158595,-68036,-40958
2017/10/11,臺指選擇權,PUT,投信,188,2,187,36,1,-34,210,14,845,114,-635,-100
2017/10/11,臺指選擇權,PUT,外資及陸資,73475,130579,60310,117707,13165,12872,307206,250890,55573,69971,251633,180919
2017/10/12,臺指選擇權,CALL,自營商,115107,260695,117218,300807,-2111,-40112,118053,528537,94929,636532,23124,-107995
2017/10/12,臺指選擇權,CALL,投信,105,572,294,265,-189,308,210,79,816,1250,-606,-1171
2017/10/12,臺指選擇權,CALL,外資及陸資,49384,152327,42244,150403,7140,1924,158516,827372,22584,203999,135932,623373
2017/10/12,臺指選擇權,PUT,自營商,139341,155538,149097,155244,-9756,294,148209,100938,226001,132935,-77792,-31997
2017/10/12,臺指選擇權,PUT,投信,0,0,0,0,0,0,210,7,845,65,-635,-58
2017/10/12,臺指選擇權,PUT,外資及陸資,42733,84515,31285,78785,11448,5730,320062,199188,56981,52884,263081,146304
2017/10/13,臺指選擇權,CALL,自營商,79097,141900,92858,193074,-13761,-51174,111676,515925,102313,687653,9363,-171728
2017/10/13,臺指選擇權,CALL,投信,53,249,55,40,-2,209,210,72,818,1042,-608,-970
2017/10/13,臺指選擇權,CALL,外資及陸資,24113,78106,23920,81234,193,-3129,158585,847710,22460,212896,136125,634814
2017/10/13,臺指選擇權,PUT,自營商,113892,120987,107963,109310,5929,11677,158319,99413,230182,117490,-71863,-18077
2017/10/13,臺指選擇權,PUT,投信,0,0,0,0,0,0,210,7,845,60,-635,-53
2017/10/13,臺指選擇權,PUT,外資及陸資,30251,55786,21411,49667,8840,6119,327989,179540,56068,45387,271921,134153
2017/10/16,臺指選擇權,CALL,自營商,132572,322778,133868,293165,-1296,29613,112111,615003,104044,780708,8067,-165705
2017/10/16,臺指選擇權,CALL,投信,0,0,0,0,0,0,210,126,818,1561,-608,-1435
2017/10/16,臺指選擇權,CALL,外資及陸資,49121,156359,50135,177867,-1014,-21508,160952,995596,25841,263540,135111,732056
2017/10/16,臺指選擇權,PUT,自營商,148726,162118,157985,158770,-9259,3348,165251,100568,246373,117050,-81122,-16482
2017/10/16,臺指選擇權,PUT,投信,212,7,207,476,5,-469,210,4,840,470,-630,-466
2017/10/16,臺指選擇權,PUT,外資及陸資,37880,93796,36789,87813,1091,5983,331792,174213,58780,41397,273012,132816
2017/10/17,臺指選擇權,CALL,自營商,134936,224292,123636,213699,11300,10593,123977,555362,104610,683554,19367,-128192
2017/10/17,臺指選擇權,CALL,投信,233,207,230,282,3,-75,210,21,815,1059,-605,-1038
2017/10/17,臺指選擇權,CALL,外資及陸資,43934,125108,44797,138010,-863,-12903,162423,883490,28175,241636,134248,641854
2017/10/17,臺指選擇權,PUT,自營商,125531,138168,138494,142028,-12963,-3860,163753,134512,257838,153655,-94085,-19143
2017/10/17,臺指選擇權,PUT,投信,0,0,0,0,0,0,210,2,840,527,-630,-525
2017/10/17,臺指選擇權,PUT,外資及陸資,35310,79100,29640,73987,5670,5112,337818,203979,59136,50972,278682,153007
2017/10/18,臺指選擇權,CALL,自營商,212183,305542,229444,343329,-17261,-37787,78435,275803,53497,322096,24938,-46293
2017/10/18,臺指選擇權,CALL,投信,236,337,245,445,-9,-107,210,200,824,1009,-614,-809
2017/10/18,臺指選擇權,CALL,外資及陸資,61543,141316,57409,146713,4134,-5397,104729,707436,14646,140565,90083,566871
2017/10/18,臺指選擇權,PUT,自營商,223740,272154,249307,294294,-25567,-22141,80759,102829,168244,166892,-87485,-64063
2017/10/18,臺指選擇權,PUT,投信,633,168,648,354,-15,-186,210,152,855,819,-645,-667
2017/10/18,臺指選擇權,PUT,外資及陸資,62717,145445,63383,149932,-666,-4487,220727,194921,28629,54337,192098,140584
2017/10/19,臺指選擇權,CALL,自營商,120979,197986,99813,206346,21166,-8360,108713,329474,62609,381299,46104,-51825
2017/10/19,臺指選擇權,CALL,投信,0,0,0,0,0,0,210,236,824,1200,-614,-964
2017/10/19,臺指選擇權,CALL,外資及陸資,38101,116140,30763,108836,7338,7305,113266,793452,15845,163290,97421,630162
2017/10/19,臺指選擇權,PUT,自營商,155069,210646,151222,250145,3847,-39499,118990,126786,202628,213462,-83638,-86676
2017/10/19,臺指選擇權,PUT,投信,0,0,0,0,0,0,210,126,855,628,-645,-502
2017/10/19,臺指選擇權,PUT,外資及陸資,36331,95872,36655,109296,-324,-13424,227186,180587,35412,73812,191774,106775
2017/10/20,臺指選擇權,CALL,自營商,116001,194182,112525,203907,3476,-9725,120594,305608,71014,374114,49580,-68506
2017/10/20,臺指選擇權,CALL,投信,0,0,0,0,0,0,210,179,824,921,-614,-742
2017/10/20,臺指選擇權,CALL,外資及陸資,33616,100339,30457,94214,3159,6125,117937,738223,17357,155703,100580,582520
2017/10/20,臺指選擇權,PUT,自營商,173360,272524,157957,270367,15403,2157,148059,165790,216294,265802,-68235,-100012
2017/10/20,臺指選擇權,PUT,投信,0,0,0,0,0,0,210,131,855,680,-645,-549
2017/10/20,臺指選擇權,PUT,外資及陸資,47362,119353,43285,122155,4077,-2803,233781,199287,37930,92947,195851,106340
2017/10/23,臺指選擇權,CALL,自營商,111187,176151,110978,184686,209,-8534,125613,298974,75824,376767,49789,-77793
2017/10/23,臺指選擇權,CALL,投信,0,0,0,0,0,0,210,152,824,813,-614,-661
2017/10/23,臺指選擇權,CALL,外資及陸資,37657,105010,33626,106977,4031,-1966,121366,729733,16755,153727,104611,576006
2017/10/23,臺指選擇權,PUT,自營商,156120,224519,132075,187804,24045,36715,168142,179417,212332,214297,-44190,-34880
2017/10/23,臺指選擇權,PUT,投信,0,0,0,0,0,0,210,116,855,568,-645,-452
2017/10/23,臺指選擇權,PUT,外資及陸資,42305,93728,35829,87366,6476,6362,239191,185409,36864,79313,202327,106096
2017/10/24,臺指選擇權,CALL,自營商,97588,148342,94580,142240,3008,6102,134938,320282,82141,393259,52797,-72977
2017/10/24,臺指選擇權,CALL,投信,0,0,0,0,0,0,210,147,824,792,-614,-645
2017/10/24,臺指選擇權,CALL,外資及陸資,25585,68340,23123,68529,2462,-189,123969,741026,16896,156908,107073,584118
2017/10/24,臺指選擇權,PUT,自營商,110722,124494,112091,144731,-1369,-20238,172368,167936,217927,214651,-45559,-46715
2017/10/24,臺指選擇權,PUT,投信,0,0,0,0,0,0,210,105,855,516,-645,-411
2017/10/24,臺指選擇權,PUT,外資及陸資,45485,90660,28246,69013,17239,21647,256344,208341,36778,73184,219566,135157
2017/10/25,臺指選擇權,CALL,自營商,146975,217738,156252,230521,-9277,-12783,97049,283067,68631,366477,28418,-83410
2017/10/25,臺指選擇權,CALL,投信,0,0,0,0,0,0,210,126,824,699,-614,-573
2017/10/25,臺指選擇權,CALL,外資及陸資,43290,110524,39202,101465,4088,9059,124314,729519,15320,150082,108994,579437
2017/10/25,臺指選擇權,PUT,自營商,178242,197765,186205,222608,-7963,-24843,106178,151330,193772,211647,-87594,-60317
2017/10/25,臺指選擇權,PUT,投信,431,4,427,86,4,-81,210,103,851,613,-641,-510
2017/10/25,臺指選擇權,PUT,外資及陸資,55707,126970,40559,91752,15148,35218,263039,237493,32293,61732,230746,175761
2017/10/26,臺指選擇權,CALL,自營商,100517,178563,89890,159359,10627,19203,114378,293158,75333,369112,39045,-75954
2017/10/26,臺指選擇權,CALL,投信,0,0,0,0,0,0,210,93,824,536,-614,-443
2017/10/26,臺指選擇權,CALL,外資及陸資,28573,70908,23303,72040,5270,-1132,130600,702831,16336,148402,114264,554429
2017/10/26,臺指選擇權,PUT,自營商,116131,160609,117315,209142,-1184,-48533,125475,161519,214253,268349,-88778,-106830
2017/10/26,臺指選擇權,PUT,投信,0,0,0,0,0,0,210,100,851,563,-641,-463
2017/10/26,臺指選擇權,PUT,外資及陸資,40189,138795,30693,105965,9496,32830,275542,301299,35300,87832,240242,213467
2017/10/27,臺指選擇權,CALL,自營商,155334,271264,157815,282976,-2481,-11712,123435,290066,86871,368439,36564,-78373
2017/10/27,臺指選擇權,CALL,投信,0,0,0,0,0,0,210,71,824,419,-614,-348
2017/10/27,臺指選擇權,CALL,外資及陸資,32055,88562,30956,101067,1099,-12505,133759,666271,18396,148626,115363,517645
2017/10/27,臺指選擇權,PUT,自營商,200609,292513,187956,313338,12653,-20825,151723,210136,227848,335945,-76125,-125809
2017/10/27,臺指選擇權,PUT,投信,0,0,0,0,0,0,210,102,851,553,-641,-451
2017/10/27,臺指選擇權,PUT,外資及陸資,58229,153481,34052,108447,24177,45034,303263,395169,38844,114677,264419,280492
2017/10/30,臺指選擇權,CALL,自營商,162464,293590,175893,323558,-13429,-29968,126607,337170,103472,422595,23135,-85425
2017/10/30,臺指選擇權,CALL,投信,0,0,0,0,0,0,210,101,824,573,-614,-472
2017/10/30,臺指選擇權,CALL,外資及陸資,51642,148170,46491,153351,5151,-5181,140606,726844,20092,167868,120514,558976
2017/10/30,臺指選擇權,PUT,自營商,206674,300453,191669,295716,15005,4737,172048,202299,233168,298956,-61120,-96657
2017/10/30,臺指選擇權,PUT,投信,0,0,0,0,0,0,210,70,851,381,-641,-311
2017/10/30,臺指選擇權,PUT,外資及陸資,52648,128230,47699,121677,4949,6553,309381,345847,40013,100823,269368,245024
2017/10/31,臺指選擇權,CALL,自營商,129087,220532,142150,259574,-13063,-39042,123092,365826,113020,499693,10072,-133867
2017/10/31,臺指選擇權,CALL,投信,0,0,0,0,0,0,210,137,824,767,-614,-630
2017/10/31,臺指選擇權,CALL,外資及陸資,30498,88811,31473,92833,-975,-4022,141327,790881,21788,191898,119539,598983
2017/10/31,臺指選擇權,PUT,自營商,180504,218503,184544,228169,-4040,-9666,180309,174270,245469,261763,-65160,-87493
2017/10/31,臺指選擇權,PUT,投信,0,0,0,0,0,0,210,46,851,245,-641,-199
2017/10/31,臺指選擇權,PUT,外資及陸資,42159,85669,34626,84125,7533,1544,320972,305587,44071,89664,276901,215923
2017/11/1,臺指選擇權,CALL,自營商,166886,312630,173994,281899,-7108,30731,100085,340332,91938,462555,8147,-122223
2017/11/1,臺指選擇權,CALL,投信,0,0,0,0,0,0,210,152,824,849,-614,-697
2017/11/1,臺指選擇權,CALL,外資及陸資,41292,112157,41829,114863,-537,-2706,139141,831421,17103,179381,122038,652040
2017/11/1,臺指選擇權,PUT,自營商,202851,235950,205326,210842,-2475,25109,126556,145491,215518,203426,-88962,-57935
2017/11/1,臺指選擇權,PUT,投信,427,4,423,137,4,-133,210,32,847,280,-637,-248
2017/11/1,臺指選擇權,PUT,外資及陸資,54598,104790,39772,86355,14826,18434,326754,294665,44674,79679,282080,214986
2017/11/2,臺指選擇權,CALL,自營商,106652,188705,101658,212550,4994,-23845,114424,306941,101283,450921,13141,-143980
2017/11/2,臺指選擇權,CALL,投信,0,0,0,0,0,0,210,100,824,591,-614,-491
2017/11/2,臺指選擇權,CALL,外資及陸資,31432,83195,26796,91056,4636,-7861,144949,765013,18275,170431,126674,594582
2017/11/2,臺指選擇權,PUT,自營商,128142,182279,117256,200239,10886,-17960,148350,173481,226426,251179,-78076,-77698
2017/11/2,臺指選擇權,PUT,投信,0,0,0,0,0,0,210,34,847,348,-637,-314
2017/11/2,臺指選擇權,PUT,外資及陸資,39481,82353,30194,75944,9287,6409,338129,321714,46762,91532,291367,230182
2017/11/3,臺指選擇權,CALL,自營商,83373,143137,99847,163436,-16474,-20299,109064,300476,112397,464829,-3333,-164353
2017/11/3,臺指選擇權,CALL,投信,0,0,0,0,0,0,210,86,824,530,-614,-444
2017/11/3,臺指選擇權,CALL,外資及陸資,23902,65938,23202,78368,700,-12429,148991,757568,21617,183912,127374,573656
2017/11/3,臺指選擇權,PUT,自營商,123201,181524,106220,158933,16981,22591,172404,175768,233499,229224,-61095,-53456
2017/11/3,臺指選擇權,PUT,投信,0,0,0,0,0,0,210,22,847,181,-637,-159
2017/11/3,臺指選擇權,PUT,外資及陸資,33962,77069,26035,68670,7927,8399,346512,297920,47218,82082,299294,215838
2017/11/6,臺指選擇權,CALL,自營商,123865,185141,126083,182195,-2218,2946,112588,280637,118139,429211,-5551,-148574
2017/11/6,臺指選擇權,CALL,投信,0,0,0,0,0,0,210,45,824,305,-614,-260
2017/11/6,臺指選擇權,CALL,外資及陸資,35370,87529,31311,91885,4059,-4356,151912,691210,20479,158023,131433,533187
2017/11/6,臺指選擇權,PUT,自營商,140988,199949,145489,208009,-4501,-8060,181417,183781,247013,250412,-65596,-66631
2017/11/6,臺指選擇權,PUT,投信,0,0,0,0,0,0,210,19,847,144,-637,-125
2017/11/6,臺指選擇權,PUT,外資及陸資,57322,125340,39908,101882,17414,23458,364285,333530,47577,85921,316708,247609
2017/11/7,臺指選擇權,CALL,自營商,126057,186490,125357,193289,700,-6799,119776,343669,124627,517850,-4851,-174181
2017/11/7,臺指選擇權,CALL,投信,0,0,0,0,0,0,210,77,824,508,-614,-431
2017/11/7,臺指選擇權,CALL,外資及陸資,34933,87156,28708,82530,6225,4625,158834,793955,21176,191382,137658,602573
2017/11/7,臺指選擇權,PUT,自營商,154586,178593,165841,181380,-11255,-2788,182236,141236,259087,191358,-76851,-50122
2017/11/7,臺指選擇權,PUT,投信,4,1,5,3,-1,-2,210,13,848,80,-638,-67
2017/11/7,臺指選擇權,PUT,外資及陸資,48480,87777,31448,75551,17032,12226,383682,279920,49942,72403,333740,207517
2017/11/8,臺指選擇權,CALL,自營商,118734,154263,120665,155802,-1931,-1539,105094,293563,111560,462691,-6466,-169128
2017/11/8,臺指選擇權,CALL,投信,0,0,0,0,0,0,210,33,824,263,-614,-230
2017/11/8,臺指選擇權,CALL,外資及陸資,27901,68521,26764,68525,1137,-4,156092,734936,15631,151456,140461,583480
2017/11/8,臺指選擇權,PUT,自營商,140104,151553,145218,144978,-5114,6575,129802,133262,226316,164402,-96514,-31140
2017/11/8,臺指選擇權,PUT,投信,529,24,556,220,-27,-196,210,8,875,251,-665,-243
2017/11/8,臺指選擇權,PUT,外資及陸資,34383,70381,30255,71159,4128,-778,383499,265717,48915,69375,334584,196342
2017/11/9,臺指選擇權,CALL,自營商,164902,237840,170209,274265,-5307,-36426,110708,222219,122481,367293,-11773,-145074
2017/11/9,臺指選擇權,CALL,投信,614,51,15,19,599,32,210,8,225,42,-15,-34
2017/11/9,臺指選擇權,CALL,外資及陸資,41651,94420,31445,90788,10206,3632,167279,569286,16612,117235,150667,452051
2017/11/9,臺指選擇權,PUT,自營商,181340,265999,171624,281617,9716,-15618,140961,203550,227759,217879,-86798,-14329
2017/11/9,臺指選擇權,PUT,投信,53,4,69,171,-16,-167,210,8,891,692,-681,-684
2017/11/9,臺指選擇權,PUT,外資及陸資,45987,107005,33886,99518,12101,7487,395294,325165,48609,94568,346685,230597
2017/11/10,臺指選擇權,CALL,自營商,132526,182873,124518,159668,8008,23205,124052,246730,127817,362621,-3765,-115891
2017/11/10,臺指選擇權,CALL,投信,0,0,20,25,-20,-25,210,4,245,52,-35,-48
2017/11/10,臺指選擇權,CALL,外資及陸資,36671,90932,27763,76728,8908,14204,177015,580075,17440,116789,159575,463286
2017/11/10,臺指選擇權,PUT,自營商,151831,250320,149027,240099,2804,10221,152944,200903,236938,208019,-83994,-7116
2017/11/10,臺指選擇權,PUT,投信,26,3,47,153,-21,-150,210,4,912,560,-702,-556
2017/11/10,臺指選擇權,PUT,外資及陸資,52509,125058,38212,118451,14297,6607,406375,288124,45393,85562,360982,202562
2017/11/13,臺指選擇權,CALL,自營商,101078,146231,102940,148009,-1862,-1778,130838,215503,136465,325342,-5627,-109839
2017/11/13,臺指選擇權,CALL,投信,0,0,0,0,0,0,210,3,245,30,-35,-27
2017/11/13,臺指選擇權,CALL,外資及陸資,24624,62354,19215,55647,5409,6707,182343,515366,17359,101570,164984,413796
2017/11/13,臺指選擇權,PUT,自營商,114833,145095,114893,157377,-60,-12282,164390,233158,248444,246837,-84054,-13679
2017/11/13,臺指選擇權,PUT,投信,43,91,20,60,23,31,240,100,919,665,-679,-565
2017/11/13,臺指選擇權,PUT,外資及陸資,30621,74034,23345,69286,7276,4748,415437,313116,47179,97986,368258,215130
2017/11/14,臺指選擇權,CALL,自營商,137089,186893,151513,206469,-14424,-19575,128783,212163,148834,336392,-20051,-124229
2017/11/14,臺指選擇權,CALL,投信,0,0,37,56,-37,-56,210,1,282,84,-72,-83
2017/11/14,臺指選擇權,CALL,外資及陸資,37147,86712,30068,80751,7079,5961,189299,490675,17236,94168,172063,396507
2017/11/14,臺指選擇權,PUT,自營商,167917,244098,147988,216399,19929,27699,176079,235962,240204,222448,-64125,13514
2017/11/14,臺指選擇權,PUT,投信,6,0,45,110,-39,-110,240,100,958,632,-718,-532
2017/11/14,臺指選擇權,PUT,外資及陸資,46206,121553,41287,113915,4919,7638,420414,316701,47237,99764,373177,216937
2017/11/15,臺指選擇權,CALL,自營商,180940,237649,211513,243655,-30573,-6005,89283,132773,64989,212013,24294,-79240
2017/11/15,臺指選擇權,CALL,投信,210,126,857,921,-647,-795,210,98,929,884,-719,-786
2017/11/15,臺指選擇權,CALL,外資及陸資,51756,114407,47397,109827,4359,4579,106840,366366,6937,68871,99903,297495
2017/11/15,臺指選擇權,PUT,自營商,204188,342527,207714,320012,-3526,22515,78664,175610,162227,211543,-83563,-35933
2017/11/15,臺指選擇權,PUT,投信,777,421,786,750,-9,-329,240,548,967,1542,-727,-994
2017/11/15,臺指選擇權,PUT,外資及陸資,85655,203648,65315,173584,20340,30063,301558,387134,29764,95312,271794,291822
2017/11/16,臺指選擇權,CALL,自營商,108186,192842,105192,211273,2994,-18430,111748,182788,84460,283548,27288,-100760
2017/11/16,臺指選擇權,CALL,投信,0,0,0,0,0,0,210,90,929,861,-719,-771
2017/11/16,臺指選擇權,CALL,外資及陸資,36142,91950,23202,76042,12940,15908,121338,387882,8495,74590,112843,313292
2017/11/16,臺指選擇權,PUT,自營商,133439,186542,126585,224635,6854,-38093,108892,178687,185601,242840,-76709,-64153
2017/11/16,臺指選擇權,PUT,投信,0,0,0,0,0,0,240,459,967,1302,-727,-843
2017/11/16,臺指選擇權,PUT,外資及陸資,27616,85388,26880,88669,736,-3281,305900,347059,33370,98481,272530,248578
2017/11/17,臺指選擇權,CALL,自營商,120948,308267,118869,268096,2079,40171,115962,261560,86595,345607,29367,-84047
2017/11/17,臺指選擇權,CALL,投信,0,0,0,0,0,0,210,147,929,1404,-719,-1257
2017/11/17,臺指選擇權,CALL,外資及陸資,43771,133810,26072,97679,17699,36131,139325,514324,8783,88979,130542,425345
2017/11/17,臺指選擇權,PUT,自營商,153522,217250,159523,226485,-6001,-9235,126016,145053,208726,187108,-82710,-42055
2017/11/17,臺指選擇權,PUT,投信,0,0,0,0,0,0,240,259,967,723,-727,-464
2017/11/17,臺指選擇權,PUT,外資及陸資,32829,88780,27029,79226,5800,9553,314533,257903,36203,76259,278330,181644
2017/11/20,臺指選擇權,CALL,自營商,100944,194629,111791,188118,-10847,6510,114373,209826,95853,282742,18520,-72916
2017/11/20,臺指選擇權,CALL,投信,15,3,0,0,15,3,210,88,914,925,-704,-837
2017/11/20,臺指選擇權,CALL,外資及陸資,30719,83275,24286,77614,6433,5661,146213,455202,9238,81890,136975,373312
2017/11/20,臺指選擇權,PUT,自營商,131976,188667,108825,159784,23151,28883,147189,185977,206748,203120,-59559,-17143
2017/11/20,臺指選擇權,PUT,投信,0,0,0,0,0,0,240,254,967,748,-727,-494
2017/11/20,臺指選擇權,PUT,外資及陸資,35583,103038,28965,87888,6618,15151,319765,281281,34817,85442,284948,195839
2017/11/21,臺指選擇權,CALL,自營商,151625,283389,148091,320007,3534,-36617,114528,357276,92474,444136,22054,-86860
2017/11/21,臺指選擇權,CALL,投信,0,0,0,0,0,0,210,226,914,2122,-704,-1896
2017/11/21,臺指選擇權,CALL,外資及陸資,55008,165765,33652,120464,21356,45301,168147,717570,9816,111286,158331,606284
2017/11/21,臺指選擇權,PUT,自營商,189647,235070,201205,240255,-11558,-5185,159409,136458,230526,142419,-71117,-5961
2017/11/21,臺指選擇權,PUT,投信,0,0,0,0,0,0,240,112,967,327,-727,-215
2017/11/21,臺指選擇權,PUT,外資及陸資,47784,138084,33860,85747,13924,52338,335798,221736,36926,47922,298872,173814
2017/11/22,臺指選擇權,CALL,自營商,252449,480011,261853,559169,-9404,-79158,93659,266850,84486,406705,9173,-139855
2017/11/22,臺指選擇權,CALL,投信,0,0,20,21,-20,-21,210,336,934,2906,-724,-2570
2017/11/22,臺指選擇權,CALL,外資及陸資,83711,237309,73719,237973,9992,-664,176004,779785,14585,123626,161419,656159
2017/11/22,臺指選擇權,PUT,自營商,252796,307608,286109,317003,-33313,-9395,115432,138036,198655,154497,-83223,-16461
2017/11/22,臺指選擇權,PUT,投信,542,17,533,116,9,-98,240,106,958,427,-718,-321
2017/11/22,臺指選擇權,PUT,外資及陸資,60033,127486,57584,120178,2449,7309,340988,218927,33648,42846,307340,176081
2017/11/23,臺指選擇權,CALL,自營商,76984,128458,74563,142302,2421,-13844,99883,286445,88289,445076,11594,-158631
2017/11/23,臺指選擇權,CALL,投信,0,0,0,0,0,0,210,373,934,3225,-724,-2852
2017/11/23,臺指選擇權,CALL,外資及陸資,23098,63257,20100,69968,2998,-6711,180302,832108,15885,134463,164417,697645
2017/11/23,臺指選擇權,PUT,自營商,98709,126356,94129,120124,4580,6233,130403,130801,209046,131934,-78643,-1133
2017/11/23,臺指選擇權,PUT,投信,0,0,0,0,0,0,240,78,958,275,-718,-197
2017/11/23,臺指選擇權,PUT,外資及陸資,26906,63269,21941,59030,4965,4239,347666,200685,35361,40045,312305,160640
2017/11/24,臺指選擇權,CALL,自營商,51466,101554,57790,113886,-6324,-12331,100639,284524,95369,456693,5270,-172169
2017/11/24,臺指選擇權,CALL,投信,0,0,13,8,-13,-8,210,368,947,3188,-737,-2820
2017/11/24,臺指選擇權,CALL,外資及陸資,17977,53948,14204,44574,3773,9374,183994,838370,15804,134483,168190,703887
2017/11/24,臺指選擇權,PUT,自營商,83340,100702,70266,100067,13074,635,143861,135931,209430,133195,-65569,2736
2017/11/24,臺指選擇權,PUT,投信,417,25,21,26,396,-1,640,96,962,279,-322,-183
2017/11/24,臺指選擇權,PUT,外資及陸資,24765,55424,17329,43717,7436,11707,355774,213246,36033,40394,319741,172852
2017/11/27,臺指選擇權,CALL,自營商,153766,225258,166544,230316,-12778,-5058,103651,212383,111159,333401,-7508,-121018
2017/11/27,臺指選擇權,CALL,投信,0,0,0,0,0,0,210,142,947,1453,-737,-1311
2017/11/27,臺指選擇權,CALL,外資及陸資,47527,103787,42342,111830,5185,-8043,190860,600209,17485,108574,173375,491635
2017/11/27,臺指選擇權,PUT,自營商,165696,271000,149425,262965,16271,8035,157691,227539,206989,204420,-49298,23119
2017/11/27,臺指選擇權,PUT,投信,0,0,0,0,0,0,640,147,962,482,-322,-335
2017/11/27,臺指選擇權,PUT,外資及陸資,59238,156151,42297,125752,16941,30399,371737,338678,35055,62173,336682,276505
2017/11/28,臺指選擇權,CALL,自營商,148105,192516,149873,182091,-1768,10424,112038,207410,121314,311214,-9276,-103804
2017/11/28,臺指選擇權,CALL,投信,33,5,10,4,23,1,210,97,924,1020,-714,-923
2017/11/28,臺指選擇權,CALL,外資及陸資,43244,97285,38621,89994,4623,7291,192960,535640,14962,96768,177998,438872
2017/11/28,臺指選擇權,PUT,自營商,158634,287486,174262,337161,-15628,-49675,155290,267286,220216,297705,-64926,-30419
2017/11/28,臺指選擇權,PUT,投信,0,0,4,3,-4,-3,640,161,966,564,-326,-403
2017/11/28,臺指選擇權,PUT,外資及陸資,61551,187064,52343,152218,9208,34846,381285,427193,35395,75906,345890,351287
2017/11/29,臺指選擇權,CALL,自營商,141770,199162,162248,211926,-20478,-12763,93110,230686,101466,345712,-8356,-115026
2017/11/29,臺指選擇權,CALL,投信,0,0,29,15,-29,-15,210,110,953,1171,-743,-1061
2017/11/29,臺指選擇權,CALL,外資及陸資,39714,84924,38633,88233,1081,-3310,193708,566949,11783,100934,181925,466015
2017/11/29,臺指選擇權,PUT,自營商,184675,279295,195812,311939,-11137,-32644,124710,199625,212641,274894,-87931,-75269
2017/11/29,臺指選擇權,PUT,投信,497,5,517,68,-20,-63,240,127,986,542,-746,-415
2017/11/29,臺指選擇權,PUT,外資及陸資,58777,181206,49491,126406,9286,54800,390962,464356,35017,69229,355945,395127
2017/11/30,臺指選擇權,CALL,自營商,190083,321292,209778,334389,-19695,-13097,108509,190037,136560,277583,-28051,-87546
2017/11/30,臺指選擇權,CALL,投信,479,86,10,5,469,81,630,83,904,339,-274,-256
2017/11/30,臺指選擇權,CALL,外資及陸資,44195,121267,49453,127824,-5258,-6557,193038,377383,16371,82711,176667,294672
2017/11/30,臺指選擇權,PUT,自營商,222129,510438,202826,517545,19303,-7107,159216,414520,227844,519103,-68628,-104583
2017/11/30,臺指選擇權,PUT,投信,0,0,9,5,-9,-5,240,346,995,1650,-755,-1304
2017/11/30,臺指選擇權,PUT,外資及陸資,72312,236150,64460,227193,7852,8958,401427,840468,37616,133381,363811,707087
2017/12/1,臺指選擇權,CALL,自營商,263117,463227,251638,414882,11479,48345,134477,281797,151049,322099,-16572,-40302
2017/12/1,臺指選擇權,CALL,投信,0,0,72,35,-72,-35,630,79,976,464,-346,-385
2017/12/1,臺指選擇權,CALL,外資及陸資,60242,177044,60338,180309,-96,-3265,196091,415235,19520,103269,176571,311966
2017/12/1,臺指選擇權,PUT,自營商,311096,604759,290381,590348,20715,14411,185522,405373,233435,461364,-47913,-55991
2017/12/1,臺指選擇權,PUT,投信,0,0,4,6,-4,-6,240,286,999,1246,-759,-960
2017/12/1,臺指選擇權,PUT,外資及陸資,88303,238038,71079,244571,17224,-6533,422537,779182,41502,134068,381035,645114
2017/12/4,臺指選擇權,CALL,自營商,165819,296800,162137,302378,3682,-5579,137085,327988,149975,376527,-12890,-48539
2017/12/4,臺指選擇權,CALL,投信,0,0,0,0,0,0,630,104,976,683,-346,-579
2017/12/4,臺指選擇權,CALL,外資及陸資,54952,160176,59633,174038,-4681,-13862,195220,477955,23330,137007,171890,340948
2017/12/4,臺指選擇權,PUT,自營商,203079,345531,212263,397843,-9184,-52313,178703,300771,235800,389324,-57097,-88553
2017/12/4,臺指選擇權,PUT,投信,0,0,0,0,0,0,240,208,999,849,-759,-641
2017/12/4,臺指選擇權,PUT,外資及陸資,77580,199319,74459,208647,3121,-9328,429676,676095,45520,125868,384156,550227
2017/12/5,臺指選擇權,CALL,自營商,162896,216098,171761,255376,-8865,-39278,132986,209308,154741,289397,-21755,-80089
2017/12/5,臺指選擇權,CALL,投信,0,0,0,0,0,0,630,40,976,337,-346,-297
2017/12/5,臺指選擇權,CALL,外資及陸資,51568,134484,52231,124773,-663,9711,194090,379137,22863,92625,171227,286512
2017/12/5,臺指選擇權,PUT,自營商,186499,306166,180504,336867,5995,-30701,186645,393511,237747,519742,-51102,-126231
2017/12/5,臺指選擇權,PUT,投信,0,0,0,0,0,0,240,315,999,1296,-759,-981
2017/12/5,臺指選擇權,PUT,外資及陸資,69049,192187,62894,179089,6155,13098,435202,881343,44891,169405,390311,711938
2017/12/6,臺指選擇權,CALL,自營商,338758,421455,414056,429779,-75298,-8325,107876,179013,156684,217486,-48808,-38473
2017/12/6,臺指選擇權,CALL,投信,1186,613,11,8,1175,605,630,436,221,45,409,391
2017/12/6,臺指選擇權,CALL,外資及陸資,71785,153106,83261,168090,-11476,-14983,192567,254718,29964,70783,162603,183935
2017/12/6,臺指選擇權,PUT,自營商,385611,897932,412660,1042434,-27049,-144503,135178,607710,240929,943799,-105751,-336089
2017/12/6,臺指選擇權,PUT,投信,553,882,587,357,-34,525,240,1055,1033,3910,-793,-2855
2017/12/6,臺指選擇權,PUT,外資及陸資,113103,351097,107831,392802,5272,-41705,437476,1711275,47984,345617,389492,1365658
2017/12/7,臺指選擇權,CALL,自營商,227609,370612,225291,355319,2318,15293,131532,211339,178022,225481,-46490,-14142
2017/12/7,臺指選擇權,CALL,投信,0,0,576,941,-576,-941,630,198,797,994,-167,-796
2017/12/7,臺指選擇權,CALL,外資及陸資,57912,157765,53296,154579,4616,3186,203218,247083,35999,77190,167219,169893
2017/12/7,臺指選擇權,PUT,自營商,262842,679894,258576,774771,4266,-94877,161255,554257,262740,976027,-101485,-421770
2017/12/7,臺指選擇權,PUT,投信,82,792,100,280,-18,513,220,866,1031,3071,-811,-2205
2017/12/7,臺指選擇權,PUT,外資及陸資,91859,267568,75558,310116,16301,-42548,460607,1699851,54814,383951,405793,1315900
2017/12/8,臺指選擇權,CALL,自營商,170378,268852,168140,259391,2238,9462,145312,232767,189564,232578,-44252,189
2017/12/8,臺指選擇權,CALL,投信,0,0,341,1084,-341,-1084,630,93,1138,2015,-508,-1922
2017/12/8,臺指選擇權,CALL,外資及陸資,47422,127407,37061,111095,10361,16312,213049,257882,35469,74577,177580,183305
2017/12/8,臺指選擇權,PUT,自營商,200373,411092,198925,405651,1448,5440,178403,466355,278440,828142,-100037,-361787
2017/12/8,臺指選擇權,PUT,投信,41,371,34,81,7,290,214,479,1018,1656,-804,-1177
2017/12/8,臺指選擇權,PUT,外資及陸資,60756,176476,50161,164270,10595,12206,472422,1411110,56034,318415,416388,1092695
2017/12/11,臺指選擇權,CALL,自營商,160800,305437,154559,268992,6241,36445,152300,319422,190311,285244,-38011,34178
2017/12/11,臺指選擇權,CALL,投信,0,0,0,0,0,0,630,179,1138,2663,-508,-2484
2017/12/11,臺指選擇權,CALL,外資及陸資,45583,136892,43398,133527,2185,3365,214614,332339,34849,100377,179765,231962
2017/12/11,臺指選擇權,PUT,自營商,188261,283023,210097,291682,-21836,-8658,173313,312160,295186,606233,-121873,-294073
2017/12/11,臺指選擇權,PUT,投信,1854,2996,58,24,1796,2972,2014,3338,1022,738,992,2600
2017/12/11,臺指選擇權,PUT,外資及陸資,53716,125873,43386,106701,10330,19172,483479,1030338,56761,222850,426718,807488
2017/12/12,臺指選擇權,CALL,自營商,190122,251109,203705,272681,-13583,-21572,153484,260142,205078,249782,-51594,10360
2017/12/12,臺指選擇權,CALL,投信,0,0,11,59,-11,-59,630,44,1149,1986,-519,-1942
2017/12/12,臺指選擇權,CALL,外資及陸資,37996,93725,43587,112685,-5591,-18959,211812,259790,37638,86737,174174,173053
2017/12/12,臺指選擇權,PUT,自營商,179701,290340,174314,298336,5387,-7997,173824,339790,290310,671948,-116486,-332158
2017/12/12,臺指選擇權,PUT,投信,0,0,0,0,0,0,2014,4470,1022,957,992,3513
2017/12/12,臺指選擇權,PUT,外資及陸資,52007,138712,48094,133972,3913,4740,488223,1184762,57592,264195,430631,920567
2017/12/13,臺指選擇權,CALL,自營商,186414,237174,191818,245181,-5404,-8007,114080,231618,159441,211991,-45361,19627
2017/12/13,臺指選擇權,CALL,投信,11,2,40,181,-29,-179,210,9,1178,2303,-968,-2294
2017/12/13,臺指選擇權,CALL,外資及陸資,52223,133242,50212,129266,2011,3976,211459,273402,33080,78431,178379,194971
2017/12/13,臺指選擇權,PUT,自營商,201375,242694,230393,290833,-29018,-48139,128446,288883,265737,640873,-137291,-351990
2017/12/13,臺指選擇權,PUT,投信,557,40,578,335,-21,-295,2014,3650,1043,1045,971,2605
2017/12/13,臺指選擇權,PUT,外資及陸資,67161,153491,65016,166191,2145,-12700,485971,1104377,55992,247520,429979,856857
2017/12/14,臺指選擇權,CALL,自營商,159138,285410,147276,314892,11862,-29482,121720,277410,155219,263680,-33499,13730
2017/12/14,臺指選擇權,CALL,投信,0,0,0,0,0,0,210,3,1178,3025,-968,-3022
2017/12/14,臺指選擇權,CALL,外資及陸資,55786,174986,50443,172936,5343,2050,219683,346661,35961,106590,183722,240071
2017/12/14,臺指選擇權,PUT,自營商,174935,258632,176839,262427,-1904,-3796,136035,206196,275230,484246,-139195,-278050
2017/12/14,臺指選擇權,PUT,投信,362,48,358,923,4,-875,2014,1129,1039,1300,975,-171
2017/12/14,臺指選擇權,PUT,外資及陸資,57555,123965,50882,121637,6673,2328,494695,811025,58043,179247,436652,631778
2017/12/15,臺指選擇權,CALL,自營商,156702,221006,175590,299527,-18888,-78521,119790,203238,172177,285477,-52387,-82239
2017/12/15,臺指選擇權,CALL,投信,0,0,0,0,0,0,210,2,1178,2249,-968,-2247
2017/12/15,臺指選擇權,CALL,外資及陸資,49946,135969,49274,138517,672,-2549,221469,284592,37075,90154,184394,194438
2017/12/15,臺指選擇權,PUT,自營商,192801,345330,155263,291980,37538,53350,163637,263486,265294,530731,-101657,-267245
2017/12/15,臺指選擇權,PUT,投信,33,90,19,55,14,36,2014,1498,1025,1544,989,-46
2017/12/15,臺指選擇權,PUT,外資及陸資,66621,201259,59856,193057,6765,8203,501433,937526,58016,207596,443417,729930
2017/12/18,臺指選擇權,CALL,自營商,125909,183928,117126,180135,8783,3793,121969,217073,165573,303288,-43604,-86215
2017/12/18,臺指選擇權,CALL,投信,0,0,2,2,-2,-2,210,2,1180,2364,-970,-2362
2017/12/18,臺指選擇權,CALL,外資及陸資,43768,125123,44403,123881,-635,1242,221550,303313,37791,97074,183759,206239
2017/12/18,臺指選擇權,PUT,自營商,120070,164267,130649,187570,-10579,-23303,163769,231017,276005,506329,-112236,-275312
2017/12/18,臺指選擇權,PUT,投信,176,15,179,373,-3,-359,2014,838,1028,1663,986,-825
2017/12/18,臺指選擇權,PUT,外資及陸資,54966,135263,54160,139254,806,-3991,504094,871214,59871,193870,444223,677344
2017/12/19,臺指選擇權,CALL,自營商,152163,221350,158100,192891,-5937,28459,134669,201166,184210,236355,-49541,-35189
2017/12/19,臺指選擇權,CALL,投信,819,287,51,283,768,3,210,2,412,1870,-202,-1868
2017/12/19,臺指選擇權,CALL,外資及陸資,52549,122796,47200,125667,5349,-2872,225718,249054,36610,75463,189108,173591
2017/12/19,臺指選擇權,PUT,自營商,160154,217630,165970,221990,-5816,-4361,169544,259143,287596,581675,-118052,-322532
2017/12/19,臺指選擇權,PUT,投信,96,3,18,39,78,-36,2014,1109,950,2062,1064,-953
2017/12/19,臺指選擇權,PUT,外資及陸資,58215,143947,58961,149216,-746,-5270,502894,988161,59417,224962,443477,763199
2017/12/20,臺指選擇權,CALL,自營商,195371,320459,203141,257911,-7770,62549,71481,212728,61751,133398,9730,79330
2017/12/20,臺指選擇權,CALL,投信,225,101,996,905,-771,-804,225,105,1198,3214,-973,-3109
2017/12/20,臺指選擇權,CALL,外資及陸資,52141,135188,51534,159488,607,-24300,70396,138581,11866,73532,58530,65049
2017/12/20,臺指選擇權,PUT,自營商,215006,266675,253552,279014,-38546,-12339,78673,138433,108261,356777,-29588,-218344
2017/12/20,臺指選擇權,PUT,投信,2191,3695,2265,1298,-74,2397,2025,2318,1039,2154,986,164
2017/12/20,臺指選擇權,PUT,外資及陸資,72792,141889,68281,168741,4511,-26852,191095,615597,28093,168678,163002,446919
2017/12/21,臺指選擇權,CALL,自營商,123558,233720,107825,213745,15733,19975,100254,232412,74791,142215,25463,90197
2017/12/21,臺指選擇權,CALL,投信,0,0,8,26,-8,-26,225,62,1206,2680,-981,-2618
2017/12/21,臺指選擇權,CALL,外資及陸資,38590,113202,35383,123080,3207,-9878,76978,132666,15241,89838,61737,42828
2017/12/21,臺指選擇權,PUT,自營商,145408,205739,133688,205212,11720,527,113486,154467,131354,366182,-17868,-211715
2017/12/21,臺指選擇權,PUT,投信,0,0,0,0,0,0,2025,1766,1039,1934,986,-168
2017/12/21,臺指選擇權,PUT,外資及陸資,54016,111642,35843,108140,18173,3502,213241,612799,32066,182323,181175,430476
2017/12/22,臺指選擇權,CALL,自營商,92384,160515,87614,149444,4770,11071,111615,284352,81382,175785,30233,108567
2017/12/22,臺指選擇權,CALL,投信,0,0,0,0,0,0,225,75,1206,3085,-981,-3010
2017/12/22,臺指選擇權,CALL,外資及陸資,24913,57720,20142,57320,4771,400,81901,148490,15393,102274,66508,46216
2017/12/22,臺指選擇權,PUT,自營商,113466,137078,102564,177675,10902,-40597,135705,136446,142671,363357,-6966,-226911
2017/12/22,臺指選擇權,PUT,投信,0,0,0,0,0,0,2025,711,1039,1380,986,-669
2017/12/22,臺指選擇權,PUT,外資及陸資,41061,141477,25603,85542,15458,55934,232914,617762,36281,182098,196633,435664
2017/12/25,臺指選擇權,CALL,自營商,75704,134246,75219,136037,485,-1790,114408,268376,83690,163636,30718,104740
2017/12/25,臺指選擇權,CALL,投信,0,0,0,0,0,0,225,52,1206,2757,-981,-2705
2017/12/25,臺指選擇權,CALL,外資及陸資,16804,47736,13898,41818,2906,5918,84869,139788,15455,94632,69414,45156
2017/12/25,臺指選擇權,PUT,自營商,107256,141333,100811,153244,6445,-11912,156284,148306,156805,381624,-521,-233318
2017/12/25,臺指選擇權,PUT,投信,0,0,0,0,0,0,2025,407,1039,1257,986,-850
2017/12/25,臺指選擇權,PUT,外資及陸資,17003,41199,14367,37190,2636,4009,236136,593071,36867,178261,199269,414810
2017/12/26,臺指選擇權,CALL,自營商,184036,268548,184514,235615,-478,32933,125408,227130,95168,106515,30240,120615
2017/12/26,臺指選擇權,CALL,投信,0,0,8,25,-8,-25,225,26,1214,1718,-989,-1692
2017/12/26,臺指選擇權,CALL,外資及陸資,41854,87796,35736,89116,6118,-1319,91797,105053,16265,74135,75532,30918
2017/12/26,臺指選擇權,PUT,自營商,206996,397478,209578,371431,-2582,26048,160543,301630,163646,570582,-3103,-268952
2017/12/26,臺指選擇權,PUT,投信,900,2558,0,0,900,2558,2925,4331,1039,2440,1886,1891
2017/12/26,臺指選擇權,PUT,外資及陸資,55711,155238,44971,128421,10740,26817,245592,858662,35583,252565,210009,606097
2017/12/27,臺指選擇權,CALL,自營商,191584,287686,189898,269032,1686,18654,94881,282091,69012,128468,25869,153623
2017/12/27,臺指選擇權,CALL,投信,0,0,0,0,0,0,225,25,1214,2092,-989,-2067
2017/12/27,臺指選擇權,CALL,外資及陸資,46152,103718,35302,88677,10850,15041,96130,139971,15553,87034,80577,52937
2017/12/27,臺指選擇權,PUT,自營商,184675,285966,231104,307302,-46429,-21336,100687,176770,149961,439852,-49274,-263082
2017/12/27,臺指選擇權,PUT,投信,1140,2011,230,50,910,1961,2025,3848,1029,1682,996,2166
2017/12/27,臺指選擇權,PUT,外資及陸資,47284,117462,42192,103107,5092,14355,242778,717007,34858,201078,207920,515929
2017/12/28,臺指選擇權,CALL,自營商,130195,238659,134387,279776,-4192,-41117,102702,370562,81025,202016,21677,168546
2017/12/28,臺指選擇權,CALL,投信,0,0,0,0,0,0,225,51,1214,3108,-989,-3057
2017/12/28,臺指選擇權,CALL,外資及陸資,44384,129316,32884,103398,11500,25918,108601,225105,16524,118274,92077,106831
2017/12/28,臺指選擇權,PUT,自營商,189430,265791,171602,275239,17828,-9448,138408,160398,169854,363452,-31446,-203054
2017/12/28,臺指選擇權,PUT,投信,0,0,0,0,0,0,2025,2126,1029,935,996,1191
2017/12/28,臺指選擇權,PUT,外資及陸資,45958,99869,36748,87467,9210,12402,255106,566577,37976,158408,217130,408169
2017/12/29,臺指選擇權,CALL,自營商,148340,315772,147385,343756,955,-27984,114911,486577,92279,307530,22632,179047
2017/12/29,臺指選擇權,CALL,投信,0,0,0,0,0,0,225,90,1214,4211,-989,-4121
2017/12/29,臺指選擇權,CALL,外資及陸資,42111,126639,33835,117111,8276,9528,116957,308539,16604,148935,100353,159604
2017/12/29,臺指選擇權,PUT,自營商,192700,253822,184124,236138,8576,17684,160329,156742,183199,290474,-22870,-133732
2017/12/29,臺指選擇權,PUT,投信,40,3,0,0,40,3,2065,1369,1029,582,1036,787
2017/12/29,臺指選擇權,PUT,外資及陸資,55105,84751,29609,74330,25496,10421,281807,471765,39181,126433,242626,345332
2018/1/2,臺指選擇權,CALL,自營商,128855,255321,116964,258068,11891,-2747,130572,647240,96049,423693,34523,223547
2018/1/2,臺指選擇權,CALL,投信,0,0,0,0,0,0,225,163,1214,5725,-989,-5562
2018/1/2,臺指選擇權,CALL,外資及陸資,43702,131874,37864,129341,5838,2533,123169,416698,16978,186881,106191,229817
2018/1/2,臺指選擇權,PUT,自營商,164661,187920,195461,213546,-30800,-25626,161172,123087,214842,231334,-53670,-108247
2018/1/2,臺指選擇權,PUT,投信,0,0,0,0,0,0,2065,892,1029,382,1036,510
2018/1/2,臺指選擇權,PUT,外資及陸資,59122,104945,35438,79178,23684,25767,308518,405884,42208,100567,266310,305317
2018/1/3,臺指選擇權,CALL,自營商,210092,516650,238899,579399,-28807,-62750,100730,640023,86760,382758,13970,257265
2018/1/3,臺指選擇權,CALL,投信,0,0,0,0,0,0,225,343,1214,8204,-989,-7861
2018/1/3,臺指選擇權,CALL,外資及陸資,70677,219744,63542,238495,7135,-18751,131219,533348,19705,230736,111514,302612
2018/1/3,臺指選擇權,PUT,自營商,241595,249555,271875,252857,-30280,-3302,122690,115152,192566,180997,-69876,-65845
2018/1/3,臺指選擇權,PUT,投信,997,124,2321,658,-1324,-534,705,112,1033,281,-328,-169
2018/1/3,臺指選擇權,PUT,外資及陸資,40594,83693,38982,81933,1612,1760,306125,311253,40516,73957,265609,237296
2018/1/4,臺指選擇權,CALL,自營商,149915,293468,142628,335188,7287,-41720,127501,733130,106244,489950,21257,243180
2018/1/4,臺指選擇權,CALL,投信,0,0,0,0,0,0,225,495,1214,9885,-989,-9390
2018/1/4,臺指選擇權,CALL,外資及陸資,34595,113956,35747,128456,-1152,-14501,130624,611727,20262,265304,110362,346423
2018/1/4,臺指選擇權,PUT,自營商,168835,206813,155126,217955,13709,-11141,154847,104020,211014,158716,-56167,-54696
2018/1/4,臺指選擇權,PUT,投信,624,56,122,113,502,-57,1185,68,1011,191,174,-123
2018/1/4,臺指選擇權,PUT,外資及陸資,41639,93201,31472,85480,10167,7721,317213,263712,41437,61264,275776,202448
2018/1/5,臺指選擇權,CALL,自營商,141378,317834,130509,283602,10869,34232,141648,770452,109522,481135,32126,289317
2018/1/5,臺指選擇權,CALL,投信,0,0,0,0,0,0,225,518,1214,10405,-989,-9887
2018/1/5,臺指選擇權,CALL,外資及陸資,34516,112359,34582,119732,-66,-7373,131834,634798,21538,279606,110296,355192
2018/1/5,臺指選擇權,PUT,自營商,165935,212380,160908,195946,5027,16434,175523,120683,226663,148204,-51140,-27521
2018/1/5,臺指選擇權,PUT,投信,72,8,70,35,2,-27,1185,43,1009,151,176,-108
2018/1/5,臺指選擇權,PUT,外資及陸資,43182,93410,36051,80617,7131,12794,324774,250447,41867,58246,282907,192201
2018/1/8,臺指選擇權,CALL,自營商,118924,241351,127470,306806,-8546,-65455,142833,799264,119253,569077,23580,230187
2018/1/8,臺指選擇權,CALL,投信,0,0,4,11,-4,-11,225,641,1218,11525,-993,-10884
2018/1/8,臺指選擇權,CALL,外資及陸資,50643,149503,49434,170918,1209,-21416,137127,687830,25622,307214,111505,380616
2018/1/8,臺指選擇權,PUT,自營商,146450,154750,141938,149155,4512,5595,183458,115736,230086,131576,-46628,-15840
2018/1/8,臺指選擇權,PUT,投信,0,0,0,0,0,0,1185,31,1009,109,176,-78
2018/1/8,臺指選擇權,PUT,外資及陸資,33570,79107,31725,74495,1845,4612,327625,236042,42873,54304,284752,181738
2018/1/9,臺指選擇權,CALL,自營商,137498,227617,122147,234825,15351,-7208,157097,762356,118166,535092,38931,227264
2018/1/9,臺指選擇權,CALL,投信,0,0,0,0,0,0,225,523,1218,10913,-993,-10390
2018/1/9,臺指選擇權,CALL,外資及陸資,35521,108075,33327,100902,2194,7173,137733,670593,24034,299786,113699,370807
2018/1/9,臺指選擇權,PUT,自營商,152868,162099,156566,170388,-3698,-8290,192191,115954,242517,134939,-50326,-18985
2018/1/9,臺指選擇權,PUT,投信,36,2,24,6,12,-4,1185,22,997,79,188,-57
2018/1/9,臺指選擇權,PUT,外資及陸資,39612,95010,41312,91940,-1700,3070,330226,233364,47174,56052,283052,177312
2018/1/10,臺指選擇權,CALL,自營商,209484,299295,219493,295370,-10009,3925,114147,601259,88234,364516,25913,236743
2018/1/10,臺指選擇權,CALL,投信,0,0,0,0,0,0,225,203,1218,7708,-993,-7505
2018/1/10,臺指選擇權,CALL,外資及陸資,61088,153047,59013,149578,2075,3469,139752,525702,23402,244362,116350,281340
2018/1/10,臺指選擇權,PUT,自營商,234061,292339,252530,325610,-18469,-33271,127187,133913,208044,194090,-80857,-60177
2018/1/10,臺指選擇權,PUT,投信,1139,74,528,172,611,-98,600,65,761,288,-161,-223
2018/1/10,臺指選擇權,PUT,外資及陸資,84966,256151,73335,225831,11631,30320,339146,347689,47322,93391,291824,254298
2018/1/11,臺指選擇權,CALL,自營商,113629,194380,123832,223981,-10203,-29601,123795,573236,108085,368504,15710,204732
2018/1/11,臺指選擇權,CALL,投信,0,0,0,0,0,0,225,124,1218,6966,-993,-6842
2018/1/11,臺指選擇權,CALL,外資及陸資,43723,119129,38178,115222,5545,3907,144307,491790,22412,230800,121895,260990
2018/1/11,臺指選擇權,PUT,自營商,168611,252320,148006,249174,20605,3146,161382,150103,221634,206404,-60252,-56301
2018/1/11,臺指選擇權,PUT,投信,1900,3217,0,0,1900,3217,2500,2539,761,160,1739,2379
2018/1/11,臺指選擇權,PUT,外資及陸資,75836,259585,63280,245799,12556,13786,354918,393090,50538,137288,304380,255802
2018/1/12,臺指選擇權,CALL,自營商,140689,329498,128366,249548,12323,79950,135726,755559,107693,446996,28033,308563
2018/1/12,臺指選擇權,CALL,投信,387,1908,327,286,60,1622,225,281,1158,8509,-933,-8228
2018/1/12,臺指選擇權,CALL,外資及陸資,41900,131633,40596,137305,1304,-5671,145475,629608,22276,283790,123199,345818
2018/1/12,臺指選擇權,PUT,自營商,159628,194300,168249,189217,-8621,5083,172502,127998,241375,156368,-68873,-28370
2018/1/12,臺指選擇權,PUT,投信,381,21,359,675,22,-653,2881,525,1120,707,1761,-182
2018/1/12,臺指選擇權,PUT,外資及陸資,33555,79535,32777,84029,778,-4494,355435,263875,50277,88016,305158,175859
2018/1/15,臺指選擇權,CALL,自營商,132727,301125,147870,357062,-15143,-55937,130583,923990,117693,609668,12890,314322
2018/1/15,臺指選擇權,CALL,投信,209,1542,179,193,30,1349,225,743,1128,10104,-903,-9361
2018/1/15,臺指選擇權,CALL,外資及陸資,49450,159404,52658,198742,-3208,-39337,146185,822615,26194,372366,119991,450249
2018/1/15,臺指選擇權,PUT,自營商,160504,200909,156223,139085,4281,61824,188077,128724,252669,106804,-64592,21920
2018/1/15,臺指選擇權,PUT,投信,194,6,184,424,10,-418,2500,103,729,834,1771,-731
2018/1/15,臺指選擇權,PUT,外資及陸資,46337,102303,42463,104681,3874,-2377,357449,215562,48417,80194,309032,135368
2018/1/16,臺指選擇權,CALL,自營商,124554,232108,121221,272532,3333,-40424,131576,959370,115353,681514,16223,277856
2018/1/16,臺指選擇權,CALL,投信,301,6766,197,860,104,5906,225,990,1024,4885,-799,-3895
2018/1/16,臺指選擇權,CALL,外資及陸資,42904,128315,40833,139962,2071,-11648,148629,887600,26567,401665,122062,485935
2018/1/16,臺指選擇權,PUT,自營商,121451,132053,146885,136339,-25434,-4286,174858,109502,264884,99076,-90026,10426
2018/1/16,臺指選擇權,PUT,投信,93,1,96,182,-3,-180,2500,85,732,928,1768,-843
2018/1/16,臺指選擇權,PUT,外資及陸資,28680,72676,26305,66596,2375,6080,359953,204390,48546,73525,311407,130865
2018/1/17,臺指選擇權,CALL,自營商,223893,420468,225038,410292,-1145,10176,75387,452543,58620,328079,16767,124464
2018/1/17,臺指選擇權,CALL,投信,306,1042,314,514,-8,528,210,205,1017,2559,-807,-2354
2018/1/17,臺指選擇權,CALL,外資及陸資,70148,186535,65473,203422,4675,-16887,98511,554256,17652,167775,80859,386481
2018/1/17,臺指選擇權,PUT,自營商,233661,257212,283400,307492,-49739,-50280,92539,105293,113969,133829,-21430,-28536
2018/1/17,臺指選擇權,PUT,投信,1143,407,489,541,654,-134,1050,372,1128,1487,-78,-1115
2018/1/17,臺指選擇權,PUT,外資及陸資,63596,140078,54601,123922,8995,16156,177543,245926,30035,87595,147508,158331
2018/1/18,臺指選擇權,CALL,自營商,219053,560730,211905,578508,7148,-17778,104042,570217,80127,437201,23915,133016
2018/1/18,臺指選擇權,CALL,投信,0,0,0,0,0,0,210,389,1017,3840,-807,-3451
2018/1/18,臺指選擇權,CALL,外資及陸資,63229,231933,68861,282673,-5632,-50740,101270,699753,26043,240679,75227,459074
2018/1/18,臺指選擇權,PUT,自營商,225216,386466,215430,383493,9786,2973,132065,170311,143709,197164,-11644,-26853
2018/1/18,臺指選擇權,PUT,投信,185,148,0,0,185,148,1050,265,943,1009,107,-744
2018/1/18,臺指選擇權,PUT,外資及陸資,66674,166144,57622,178447,9052,-12303,194099,248606,37539,120819,156560,127787
2018/1/19,臺指選擇權,CALL,自營商,113607,256438,110033,281684,3574,-25245,111776,700559,84287,561420,27489,139139
2018/1/19,臺指選擇權,CALL,投信,0,0,70,1535,-70,-1535,210,578,1087,7192,-877,-6614
2018/1/19,臺指選擇權,CALL,外資及陸資,35313,122418,29827,111442,5486,10976,106858,888641,26145,298133,80713,590508
2018/1/19,臺指選擇權,PUT,自營商,147406,227550,146731,225548,675,2001,154151,156126,165120,141737,-10969,14389
2018/1/19,臺指選擇權,PUT,投信,0,0,0,0,0,0,1050,174,943,668,107,-494
2018/1/19,臺指選擇權,PUT,外資及陸資,41058,103788,32730,90641,8328,13146,205265,218941,40377,95766,164888,123175
2018/1/22,臺指選擇權,CALL,自營商,175185,415913,203720,548707,-28535,-132793,111203,861716,112249,857047,-1046,4669
2018/1/22,臺指選擇權,CALL,投信,0,0,0,0,0,0,210,945,1087,9840,-877,-8895
2018/1/22,臺指選擇權,CALL,外資及陸資,60760,215549,63101,230945,-2341,-15396,106432,1126077,28060,381441,78372,744636
2018/1/22,臺指選擇權,PUT,自營商,223364,304514,210789,289152,12575,15361,180070,158621,178464,122345,1606,36276
2018/1/22,臺指選擇權,PUT,投信,0,0,0,0,0,0,1050,133,943,511,107,-378
2018/1/22,臺指選擇權,PUT,外資及陸資,68522,166627,52497,135232,16025,31395,224444,228693,43531,86349,180913,142344
2018/1/23,臺指選擇權,CALL,自營商,216745,479139,207882,493516,8863,-14377,132175,874797,124358,877488,7817,-2691
2018/1/23,臺指選擇權,CALL,投信,0,0,0,0,0,0,210,956,1087,9891,-877,-8935
2018/1/23,臺指選擇權,CALL,外資及陸資,67395,224257,68723,229323,-1328,-5067,105997,1149389,28953,386417,77044,762972
2018/1/23,臺指選擇權,PUT,自營商,226580,295676,211548,280550,15032,15127,207192,195161,190554,139799,16638,55362
2018/1/23,臺指選擇權,PUT,投信,0,0,0,0,0,0,1050,119,943,474,107,-355
2018/1/23,臺指選擇權,PUT,外資及陸資,66422,155503,55683,140996,10739,14507,239635,256155,47983,98205,191652,157950
2018/1/24,臺指選擇權,CALL,自營商,257338,354230,288110,386601,-30772,-32371,90779,561602,92362,584816,-1583,-23214
2018/1/24,臺指選擇權,CALL,投信,0,0,0,0,0,0,210,515,1087,6668,-877,-6153
2018/1/24,臺指選擇權,CALL,外資及陸資,65673,172489,60307,149148,5366,23341,109086,895573,26369,286361,82717,609212
2018/1/24,臺指選擇權,PUT,自營商,272707,416291,294496,470651,-21789,-54361,134826,213911,155334,190020,-20508,23891
2018/1/24,臺指選擇權,PUT,投信,727,62,245,120,482,-58,658,198,909,718,-251,-520
2018/1/24,臺指選擇權,PUT,外資及陸資,93686,224542,81094,210540,12592,14001,246998,323188,44552,120516,202446,202672
2018/1/25,臺指選擇權,CALL,自營商,192342,407700,176986,398148,15356,9551,117728,622868,103955,636811,13773,-13943
2018/1/25,臺指選擇權,CALL,投信,30,177,0,0,30,177,210,599,1057,7182,-847,-6583
2018/1/25,臺指選擇權,CALL,外資及陸資,75598,246301,71070,235559,4528,10742,113922,968819,26677,301484,87245,667335
2018/1/25,臺指選擇權,PUT,自營商,212531,385736,223461,409997,-10930,-24261,164763,248383,196201,244469,-31438,3914
2018/1/25,臺指選擇權,PUT,投信,392,27,0,0,392,27,1050,186,909,622,141,-436
2018/1/25,臺指選擇權,PUT,外資及陸資,113869,247711,75914,221786,37955,25925,288007,359772,47606,128821,240401,230951
2018/1/26,臺指選擇權,CALL,自營商,166811,293314,164157,325247,2654,-31932,137672,623258,121245,671718,16427,-48460
2018/1/26,臺指選擇權,CALL,投信,15,38,0,0,15,38,210,567,1042,6984,-832,-6417
2018/1/26,臺指選擇權,CALL,外資及陸資,62851,188527,64416,203396,-1565,-14869,114670,965252,28990,308920,85680,656332
2018/1/26,臺指選擇權,PUT,自營商,180743,338626,163503,372544,17240,-33918,190516,252443,204714,283318,-14198,-30875
2018/1/26,臺指選擇權,PUT,投信,18,10,0,0,18,10,1050,137,891,515,159,-378
2018/1/26,臺指選擇權,PUT,外資及陸資,77488,230509,73485,225042,4003,5467,292599,363262,48195,128456,244404,234806
2018/1/29,臺指選擇權,CALL,自營商,172122,274595,153428,304636,18694,-30041,173091,708752,137970,797092,35121,-88340
2018/1/29,臺指選擇權,CALL,投信,0,0,0,0,0,0,210,735,1042,8265,-832,-7530
2018/1/29,臺指選擇權,CALL,外資及陸資,56569,170828,54276,169031,2293,1797,117430,1104457,29457,351504,87973,752953
2018/1/29,臺指選擇權,PUT,自營商,176324,257254,151953,240297,24371,16957,212639,226641,202466,211701,10173,14940
2018/1/29,臺指選擇權,PUT,投信,950,2573,0,0,950,2573,2000,2340,891,331,1109,2009
2018/1/29,臺指選擇權,PUT,外資及陸資,57403,139863,51998,134942,5405,4921,300505,322041,50696,110428,249809,211613
2018/1/30,臺指選擇權,CALL,自營商,223125,303157,214471,292307,8654,10850,189643,492233,145868,528879,43775,-36646
2018/1/30,臺指選擇權,CALL,投信,0,0,0,0,0,0,210,326,1042,4894,-832,-4568
2018/1/30,臺指選擇權,CALL,外資及陸資,66469,171262,58085,155468,8384,15793,123533,807937,27176,245909,96357,562028
2018/1/30,臺指選擇權,PUT,自營商,229813,391762,223897,413840,5916,-22078,228048,386496,211959,394993,16089,-8497
2018/1/30,臺指選擇權,PUT,投信,950,2507,0,0,950,2507,2950,8720,891,694,2059,8026
2018/1/30,臺指選擇權,PUT,外資及陸資,86826,251269,72818,212682,14008,38588,315193,515230,51376,182145,263817,333085
2018/1/31,臺指選擇權,CALL,自營商,282986,430970,296120,439759,-13134,-8788,110717,544600,94948,577919,15769,-33319
2018/1/31,臺指選擇權,CALL,投信,0,0,33,33,-33,-33,210,378,1075,5593,-865,-5215
2018/1/31,臺指選擇權,CALL,外資及陸資,89501,208407,86868,210554,2633,-2148,121895,874101,26379,264168,95516,609933
2018/1/31,臺指選擇權,PUT,自營商,303946,521134,344913,607881,-40967,-86747,165911,280954,196585,366419,-30674,-85465
2018/1/31,臺指選擇權,PUT,投信,469,41,282,99,187,-58,2334,7186,928,625,1406,6561
2018/1/31,臺指選擇權,PUT,外資及陸資,114688,331069,101512,277204,13176,53865,317395,530135,52661,169578,264734,360557
2018/2/1,臺指選擇權,CALL,自營商,119156,252491,109644,276214,9512,-23723,131740,638335,106459,708334,25281,-69999
2018/2/1,臺指選擇權,CALL,投信,0,0,0,0,0,0,210,546,1075,7054,-865,-6508
2018/2/1,臺指選擇權,CALL,外資及陸資,44880,138547,40442,136868,4438,1679,128690,1029207,28746,313399,99944,715808
2018/2/1,臺指選擇權,PUT,自營商,161592,273103,155178,297025,6414,-23922,191045,252560,215305,360674,-24260,-108114
2018/2/1,臺指選擇權,PUT,投信,414,63,68,25,346,38,2670,5059,918,363,1752,4696
2018/2/1,臺指選擇權,PUT,外資及陸資,76319,163983,44822,125357,31497,38625,350791,517704,54570,150063,296221,367641
2018/2/2,臺指選擇權,CALL,自營商,171697,300133,158115,315781,13582,-15648,157907,554996,119044,629010,38863,-74014
2018/2/2,臺指選擇權,CALL,投信,0,0,0,0,0,0,210,341,1075,5532,-865,-5191
2018/2/2,臺指選擇權,CALL,外資及陸資,58004,166494,62141,181660,-4137,-15166,126541,885775,30734,282147,95807,603628
2018/2/2,臺指選擇權,PUT,自營商,184975,369362,165483,353700,19492,15662,220188,295766,224956,401790,-4768,-106024
2018/2/2,臺指選擇權,PUT,投信,0,0,0,0,0,0,2670,5914,918,405,1752,5509
2018/2/2,臺指選擇權,PUT,外資及陸資,77242,214307,68896,213605,8346,702,361471,561170,56904,171854,304567,389316
2018/2/5,臺指選擇權,CALL,自營商,239870,399462,264081,411195,-24211,-11733,153631,385032,138979,408488,14652,-23456
2018/2/5,臺指選擇權,CALL,投信,33,5,0,0,33,5,210,76,1042,2329,-832,-2253
2018/2/5,臺指選擇權,CALL,外資及陸資,72176,176641,58986,160845,13190,15796,140990,569368,31993,184045,108997,385323
2018/2/5,臺指選擇權,PUT,自營商,302668,917533,309485,964581,-6817,-47048,228316,589536,239901,713034,-11585,-123498
2018/2/5,臺指選擇權,PUT,投信,0,0,560,661,-560,-661,2110,14207,918,1486,1192,12721
2018/2/5,臺指選擇權,PUT,外資及陸資,124359,443286,112843,441787,11516,1499,377108,1003976,61025,334797,316083,669179
2018/2/6,臺指選擇權,CALL,自營商,339848,1197773,386384,1630844,-46536,-433071,203553,482710,235437,598130,-31884,-115420
2018/2/6,臺指選擇權,CALL,投信,81,21,14,82,67,-61,210,81,975,1087,-765,-1006
2018/2/6,臺指選擇權,CALL,外資及陸資,61401,209597,57648,297021,3753,-87424,156476,540057,43726,167024,112750,373033
2018/2/6,臺指選擇權,PUT,自營商,439633,5016502,556078,7837939,-116445,-2821437,188925,2884495,316955,5009642,-128030,-2125147
2018/2/6,臺指選擇權,PUT,投信,0,0,250,8516,-250,-8516,1860,56063,918,19604,942,36459
2018/2/6,臺指選擇權,PUT,外資及陸資,101763,1096512,195251,2914082,-93488,-1817570,362089,5801475,139494,2775060,222595,3026415
2018/2/7,臺指選擇權,CALL,自營商,297221,727460,360131,782396,-62910,-54936,109413,364432,142218,442244,-32805,-77812
2018/2/7,臺指選擇權,CALL,投信,573,96,245,434,328,-339,210,17,647,812,-437,-795
2018/2/7,臺指選擇權,CALL,外資及陸資,153007,454804,167472,507863,-14465,-53060,132549,358481,46786,168238,85763,190243
2018/2/7,臺指選擇權,PUT,自營商,327736,1201418,341821,966393,-14085,235026,134256,1175976,247999,2027965,-113743,-851989
2018/2/7,臺指選擇權,PUT,投信,2218,16910,1994,37033,224,-20123,2078,16152,912,9035,1166,7117
2018/2/7,臺指選擇權,PUT,外資及陸資,169808,559645,195904,871417,-26096,-311772,321261,2949108,140703,1732455,180558,1216653
2018/2/8,臺指選擇權,CALL,自營商,96053,245654,98830,235555,-2777,10098,124648,361672,160230,426532,-35582,-64860
2018/2/8,臺指選擇權,CALL,投信,8,2,8,52,0,-49,210,20,647,606,-437,-586
2018/2/8,臺指選擇權,CALL,外資及陸資,41977,160349,40673,180185,1304,-19836,138529,341818,51462,178434,87067,163384
2018/2/8,臺指選擇權,PUT,自營商,98134,432177,94826,387311,3308,44866,145429,1150132,255864,1935447,-110435,-785315
2018/2/8,臺指選擇權,PUT,投信,140,1674,106,365,34,1309,2078,12705,878,6622,1200,6083
2018/2/8,臺指選擇權,PUT,外資及陸資,62901,248695,58273,304394,4628,-55698,334902,2771550,149716,1672331,185186,1099219
2018/2/9,臺指選擇權,CALL,自營商,135494,560023,154247,606473,-18753,-46450,129875,385675,184210,503657,-54335,-117982
2018/2/9,臺指選擇權,CALL,投信,415,188,87,1053,328,-864,210,20,319,1275,-109,-1255
2018/2/9,臺指選擇權,CALL,外資及陸資,68210,316892,73272,343078,-5062,-26186,140952,316930,58947,207174,82005,109756
2018/2/9,臺指選擇權,PUT,自營商,152774,976389,152876,1011446,-102,-35057,149271,1724349,259808,2874259,-110537,-1149910
2018/2/9,臺指選擇權,PUT,投信,109,2051,285,2093,-176,-42,1910,23051,886,10260,1024,12791
2018/2/9,臺指選擇權,PUT,外資及陸資,82031,795954,80451,836332,1580,-40378,342951,4310986,156265,2692358,186686,1618628
2018/2/12,臺指選擇權,CALL,自營商,147724,416228,149323,437677,-1599,-21450,145405,417827,201339,550396,-55934,-132569
2018/2/12,臺指選擇權,CALL,投信,0,0,0,0,0,0,210,9,319,1185,-109,-1176
2018/2/12,臺指選擇權,CALL,外資及陸資,66391,261390,61993,294804,4398,-33414,156866,333793,70463,268484,86403,65309
2018/2/12,臺指選擇權,PUT,自營商,149627,639151,169048,586418,-19421,52733,165632,1485122,295590,2415674,-129958,-930552
2018/2/12,臺指選擇權,PUT,投信,55,755,1756,14574,-1701,-13820,210,2415,887,6961,-677,-4546
2018/2/12,臺指選擇權,PUT,外資及陸資,85283,319132,67107,364887,18176,-45755,361171,3435659,156309,2131002,204862,1304657
2018/2/21,臺指選擇權,CALL,自營商,215474,550906,221056,441542,-5582,109363,69758,434999,92065,391932,-22307,43067
2018/2/21,臺指選擇權,CALL,投信,24,72,625,1885,-601,-1813,0,0,710,3900,-710,-3900
2018/2/21,臺指選擇權,CALL,外資及陸資,71618,263308,68412,266466,3206,-3158,88751,426399,46966,370699,41785,55700
2018/2/21,臺指選擇權,PUT,自營商,222309,358209,253445,383578,-31136,-25368,82476,434676,157112,925576,-74636,-490900
2018/2/21,臺指選擇權,PUT,投信,1125,487,661,3826,464,-3339,448,426,661,3834,-213,-3408
2018/2/21,臺指選擇權,PUT,外資及陸資,54994,155488,60196,172686,-5202,-17198,187235,1292285,119211,769441,68024,522844
2018/2/22,臺指選擇權,CALL,自營商,77387,217941,83160,223825,-5773,-5883,79526,397070,107606,363336,-28080,33734
2018/2/22,臺指選擇權,CALL,投信,0,0,0,0,0,0,0,0,710,3178,-710,-3178
2018/2/22,臺指選擇權,CALL,外資及陸資,35884,120406,35599,138446,285,-18040,91590,379664,49520,349229,42070,30435
2018/2/22,臺指選擇權,PUT,自營商,79913,272162,76908,250758,3005,21404,97061,536190,168692,1036064,-71631,-499874
2018/2/22,臺指選擇權,PUT,投信,0,0,0,0,0,0,448,448,661,4429,-213,-3981
2018/2/22,臺指選擇權,PUT,外資及陸資,38170,170382,36570,163201,1600,7181,192116,1445520,122492,878743,69624,566777
2018/2/23,臺指選擇權,CALL,自營商,141602,303348,132923,269977,8679,33371,96190,570886,115591,486739,-19401,84147
2018/2/23,臺指選擇權,CALL,投信,0,0,0,0,0,0,0,0,710,4451,-710,-4451
2018/2/23,臺指選擇權,CALL,外資及陸資,45213,181395,39627,165352,5586,16042,98324,506258,50668,451922,47656,54336
2018/2/23,臺指選擇權,PUT,自營商,132946,239818,140488,284007,-7542,-44190,101923,371524,181096,773712,-79173,-402188
2018/2/23,臺指選擇權,PUT,投信,168,59,0,0,168,59,616,179,661,2479,-45,-2300
2018/2/23,臺指選擇權,PUT,外資及陸資,43696,144079,41422,145590,2274,-1511,196609,1014537,124711,603765,71898,410772
2018/2/26,臺指選擇權,CALL,自營商,146085,221634,157583,253981,-11498,-32347,99787,588776,130686,520771,-30899,68005
2018/2/26,臺指選擇權,CALL,投信,0,0,0,0,0,0,0,0,710,4581,-710,-4581
2018/2/26,臺指選擇權,CALL,外資及陸資,33071,119801,34630,124756,-1559,-4956,97904,516682,51807,470835,46097,45847
2018/2/26,臺指選擇權,PUT,自營商,118550,221618,115076,222684,3474,-1066,110693,347604,186392,700608,-75699,-353004
2018/2/26,臺指選擇權,PUT,投信,0,0,0,0,0,0,616,49,661,1884,-45,-1835
2018/2/26,臺指選擇權,PUT,外資及陸資,34964,112632,33658,103997,1306,8635,197748,877195,124544,508461,73204,368734
2018/2/27,臺指選擇權,CALL,自營商,140470,278404,134877,271563,5593,6841,105453,543675,130759,458397,-25306,85278
2018/2/27,臺指選擇權,CALL,投信,0,0,0,0,0,0,0,0,710,4033,-710,-4033
2018/2/27,臺指選擇權,CALL,外資及陸資,33205,117807,37963,135490,-4758,-17684,96670,464737,55331,446826,41339,17911
2018/2/27,臺指選擇權,PUT,自營商,143940,278773,155548,274921,-11608,3852,119437,407989,206744,776170,-87307,-368181
2018/2/27,臺指選擇權,PUT,投信,0,0,0,0,0,0,616,38,661,2016,-45,-1978
2018/2/27,臺指選擇權,PUT,外資及陸資,42307,110506,42391,136657,-84,-26151,202988,924929,129868,571049,73120,353880
2018/3/1,臺指選擇權,CALL,自營商,222467,462382,234466,442162,-11999,20220,82138,474468,110501,417332,-28363,57136
2018/3/1,臺指選擇權,CALL,投信,0,0,18,32,-18,-32,0,0,728,3579,-728,-3579
2018/3/1,臺指選擇權,CALL,外資及陸資,64121,185054,62165,182662,1956,2392,96267,426186,54021,408898,42246,17288
2018/3/1,臺指選擇權,PUT,自營商,249743,489189,261495,490348,-11752,-1159,89643,463136,176360,893364,-86717,-430228
2018/3/1,臺指選擇權,PUT,投信,224,224,20,35,204,189,224,269,680,2750,-456,-2481
2018/3/1,臺指選擇權,PUT,外資及陸資,83853,250422,81942,233169,1911,17254,207586,1115773,133640,688747,73946,427026
2018/3/2,臺指選擇權,CALL,自營商,134148,371160,136638,392496,-2490,-21336,99465,476093,130318,446819,-30853,29274
2018/3/2,臺指選擇權,CALL,投信,0,0,0,0,0,0,0,0,728,3091,-728,-3091
2018/3/2,臺指選擇權,CALL,外資及陸資,44287,168608,46190,182665,-1903,-14057,97878,393068,57535,391417,40343,1651
2018/3/2,臺指選擇權,PUT,自營商,125685,473427,117558,459358,8127,14069,105905,592898,184495,1080808,-78590,-487910
2018/3/2,臺指選擇權,PUT,投信,0,0,224,514,-224,-514,0,0,680,3350,-680,-3350
2018/3/2,臺指選擇權,PUT,外資及陸資,51013,232990,50162,220606,851,12384,209185,1319617,134388,809325,74797,510292
2018/3/5,臺指選擇權,CALL,自營商,147849,370738,155429,403062,-7580,-32323,107836,429202,146269,419001,-38433,10201
2018/3/5,臺指選擇權,CALL,投信,0,0,0,0,0,0,0,0,728,2379,-728,-2379
2018/3/5,臺指選擇權,CALL,外資及陸資,55077,254923,53824,199683,1253,55240,99649,338087,58053,289230,41596,48857
2018/3/5,臺指選擇權,PUT,自營商,155102,479514,157005,481128,-1903,-1614,118535,656959,199028,1146492,-80493,-489533
2018/3/5,臺指選擇權,PUT,投信,0,0,0,0,0,0,0,0,680,3343,-680,-3343
2018/3/5,臺指選擇權,PUT,外資及陸資,69610,248357,67228,277842,2382,-29485,212905,1367210,135726,872712,77179,494498
2018/3/6,臺指選擇權,CALL,自營商,157210,384221,142373,334983,14837,49238,121275,605722,144871,525776,-23596,79946
2018/3/6,臺指選擇權,CALL,投信,0,0,0,0,0,0,0,0,728,3183,-728,-3183
2018/3/6,臺指選擇權,CALL,外資及陸資,50340,187315,49638,166891,702,20425,101107,425271,58809,362912,42298,62359
2018/3/6,臺指選擇權,PUT,自營商,180554,357028,182846,362736,-2292,-5708,128202,414950,210987,740946,-82785,-325996
2018/3/6,臺指選擇權,PUT,投信,1800,10972,0,0,1800,10972,1800,9450,680,1423,1120,8027
2018/3/6,臺指選擇權,PUT,外資及陸資,55296,151938,51552,164532,3744,-12594,217243,866012,136320,539541,80923,326471
2018/3/7,臺指選擇權,CALL,自營商,221780,389253,233517,386774,-11737,2478,98404,457307,123575,435318,-25171,21989
2018/3/7,臺指選擇權,CALL,投信,0,0,80,1526,-80,-1526,0,0,808,4068,-808,-4068
2018/3/7,臺指選擇權,CALL,外資及陸資,62765,166112,62832,177053,-67,-10941,101381,364003,59180,304547,42201,59456
2018/3/7,臺指選擇權,PUT,自營商,254578,450089,284257,491129,-29679,-41040,105220,519259,201424,964231,-96204,-444972
2018/3/7,臺指選擇權,PUT,投信,19,0,0,0,19,0,1800,13050,661,2214,1139,10836
2018/3/7,臺指選擇權,PUT,外資及陸資,69317,168459,67115,167641,2202,817,216406,1089740,136087,693413,80319,396327
2018/3/8,臺指選擇權,CALL,自營商,89879,242933,82923,222627,6956,20307,114168,613695,132383,546449,-18215,67246
2018/3/8,臺指選擇權,CALL,投信,0,0,0,0,0,0,0,0,808,5364,-808,-5364
2018/3/8,臺指選擇權,CALL,外資及陸資,27280,112563,27774,113222,-494,-658,103284,455692,61577,394485,41707,61207
2018/3/8,臺指選擇權,PUT,自營商,127076,262842,139891,292523,-12815,-29681,119405,396995,228424,741094,-109019,-344099
2018/3/8,臺指選擇權,PUT,投信,448,245,0,0,448,245,2248,7862,661,1124,1587,6738
2018/3/8,臺指選擇權,PUT,外資及陸資,45979,118158,38718,120880,7261,-2722,224494,776375,136914,480741,87580,295634
2018/3/9,臺指選擇權,CALL,自營商,94338,240484,95943,255353,-1605,-14869,117660,639574,137480,574992,-19820,64582
2018/3/9,臺指選擇權,CALL,投信,0,0,0,0,0,0,0,0,808,5689,-808,-5689
2018/3/9,臺指選擇權,CALL,外資及陸資,33858,122131,35208,134067,-1350,-11936,104497,479542,64140,428696,40357,50846
2018/3/9,臺指選擇權,PUT,自營商,122600,254013,122154,256876,446,-2863,119292,352453,227865,647881,-108573,-295428
2018/3/9,臺指選擇權,PUT,投信,0,0,0,0,0,0,2248,5906,661,777,1587,5129
2018/3/9,臺指選擇權,PUT,外資及陸資,43988,121642,39068,125266,4920,-3624,231417,677591,138917,416903,92500,260688
2018/3/12,臺指選擇權,CALL,自營商,137978,387650,135722,413810,2256,-26160,123344,938105,140908,837162,-17564,100943
2018/3/12,臺指選擇權,CALL,投信,0,0,0,0,0,0,0,0,808,8627,-808,-8627
2018/3/12,臺指選擇權,CALL,外資及陸資,45469,204656,43466,167582,2003,37073,111815,721506,69455,608048,42360,113458
2018/3/12,臺指選擇權,PUT,自營商,172259,250052,199967,303626,-27708,-53574,133825,246948,270106,480084,-136281,-233136
2018/3/12,臺指選擇權,PUT,投信,0,0,0,0,0,0,2248,2151,661,314,1587,1837
2018/3/12,臺指選擇權,PUT,外資及陸資,44041,99087,41552,119637,2489,-20550,237030,444349,142041,276252,94989,168097
2018/3/13,臺指選擇權,CALL,自營商,139395,340023,138225,401911,1170,-61889,126819,1079522,143213,998167,-16394,81355
2018/3/13,臺指選擇權,CALL,投信,0,0,0,0,0,0,0,0,808,10579,-808,-10579
2018/3/13,臺指選擇權,CALL,外資及陸資,46440,200971,46264,166703,176,34268,110507,857124,67971,680117,42536,177007
2018/3/13,臺指選擇權,PUT,自營商,184931,216512,193517,222712,-8586,-6200,137328,214746,282195,386215,-144867,-171469
2018/3/13,臺指選擇權,PUT,投信,331,94,328,351,3,-257,2248,1136,658,391,1590,745
2018/3/13,臺指選擇權,PUT,外資及陸資,35674,88553,38101,104322,-2427,-15768,240376,364527,147814,232511,92562,132016
2018/3/14,臺指選擇權,CALL,自營商,188569,334441,206069,329955,-17500,4486,96020,748667,120437,712715,-24417,35952
2018/3/14,臺指選擇權,CALL,投信,0,0,0,0,0,0,0,0,808,8503,-808,-8503
2018/3/14,臺指選擇權,CALL,外資及陸資,56113,163659,56455,166385,-342,-2726,107047,695696,67407,562618,39640,133078
2018/3/14,臺指選擇權,PUT,自營商,218328,305728,222657,293360,-4329,12368,111997,257266,218830,438681,-106833,-181415
2018/3/14,臺指選擇權,PUT,投信,389,187,163,135,226,52,2024,1569,656,598,1368,971
2018/3/14,臺指選擇權,PUT,外資及陸資,85091,187727,70122,171881,14969,15845,241435,466908,147707,293828,93728,173080
2018/3/15,臺指選擇權,CALL,自營商,80238,198003,78042,197453,2196,550,104160,761654,126381,724012,-22221,37642
2018/3/15,臺指選擇權,CALL,投信,0,0,0,0,0,0,0,0,808,8360,-808,-8360
2018/3/15,臺指選擇權,CALL,外資及陸資,33253,116484,34221,123475,-968,-6991,108146,692595,69474,569085,38672,123510
2018/3/15,臺指選擇權,PUT,自營商,87217,166211,91798,183355,-4581,-17144,115606,241143,227020,420563,-111414,-179420
2018/3/15,臺指選擇權,PUT,投信,83,12,0,0,83,12,2024,927,573,355,1451,572
2018/3/15,臺指選擇權,PUT,外資及陸資,42148,127774,36927,130738,5221,-2964,248763,434519,149814,278342,98949,156177
2018/3/16,臺指選擇權,CALL,自營商,133008,290251,152989,356830,-19981,-66579,99154,683323,141356,718587,-42202,-35264
2018/3/16,臺指選擇權,CALL,投信,0,0,0,0,0,0,0,0,808,7422,-808,-7422
2018/3/16,臺指選擇權,CALL,外資及陸資,48217,150995,51793,149990,-3576,1005,106476,637686,71380,526505,35096,111181
2018/3/16,臺指選擇權,PUT,自營商,136394,313823,124073,276744,12321,37079,129890,300246,228983,451130,-99093,-150884
2018/3/16,臺指選擇權,PUT,投信,41,7,110,64,-69,-57,2024,762,642,342,1382,420
2018/3/16,臺指選擇權,PUT,外資及陸資,56864,182160,48739,166105,8125,16056,256827,467627,149753,293011,107074,174616
2018/3/19,臺指選擇權,CALL,自營商,107881,263640,102664,237262,5217,26377,103450,703022,140435,710073,-36985,-7051
2018/3/19,臺指選擇權,CALL,投信,18,16,0,0,18,16,0,0,790,7198,-790,-7198
2018/3/19,臺指選擇權,CALL,外資及陸資,34062,107169,32862,100682,1200,6487,108245,637086,71949,526251,36296,110835
2018/3/19,臺指選擇權,PUT,自營商,114128,196996,123676,214548,-9548,-17552,131670,283382,240311,445887,-108641,-162505
2018/3/19,臺指選擇權,PUT,投信,158,30,152,881,6,-851,2024,391,636,1006,1388,-615
2018/3/19,臺指選擇權,PUT,外資及陸資,38087,97682,35737,105387,2350,-7705,260875,433279,151451,274449,109424,158830
2018/3/20,臺指選擇權,CALL,自營商,93233,167543,98564,209702,-5331,-42159,105457,666835,147773,713573,-42316,-46738
2018/3/20,臺指選擇權,CALL,投信,165,4869,85,1917,80,2952,0,0,710,3310,-710,-3310
2018/3/20,臺指選擇權,CALL,外資及陸資,42284,146874,41652,133315,632,13560,113187,639156,76259,520944,36928,118212
2018/3/20,臺指選擇權,PUT,自營商,126817,185841,117295,190285,9522,-4444,137170,298821,236289,475549,-99119,-176728
2018/3/20,臺指選擇權,PUT,投信,78,9,73,403,5,-393,2024,119,631,1388,1393,-1269
2018/3/20,臺指選擇權,PUT,外資及陸資,52427,145341,51121,139415,1306,5926,265554,477057,154824,306805,110730,170252
2018/3/21,臺指選擇權,CALL,自營商,183472,418183,194732,360725,-11260,57458,47627,205913,61218,282605,-13591,-76692
2018/3/21,臺指選擇權,CALL,投信,625,1282,597,1670,28,-388,0,0,682,3622,-682,-3622
2018/3/21,臺指選擇權,CALL,外資及陸資,67772,175581,51628,158721,16144,16860,66377,349217,34648,179653,31729,169564
2018/3/21,臺指選擇權,PUT,自營商,181764,251268,198009,264361,-16245,-13094,64881,228427,123198,447520,-58317,-219093
2018/3/21,臺指選擇權,PUT,投信,1754,2824,400,680,1354,2144,1348,2699,625,1890,723,809
2018/3/21,臺指選擇權,PUT,外資及陸資,61549,139135,47179,120664,14370,18471,108234,437745,61897,256403,46337,181342
2018/3/22,臺指選擇權,CALL,自營商,139778,413346,132875,333560,6903,79786,67051,262738,73739,264307,-6688,-1569
2018/3/22,臺指選擇權,CALL,投信,0,0,0,0,0,0,0,0,682,3085,-682,-3085
2018/3/22,臺指選擇權,CALL,外資及陸資,47771,173822,51002,236895,-3231,-63073,73757,327276,45260,228079,28497,99197
2018/3/22,臺指選擇權,PUT,自營商,155684,422128,164596,386688,-8912,35440,82548,321674,149777,483657,-67229,-161983
2018/3/22,臺指選擇權,PUT,投信,900,1089,0,0,900,1089,2248,4018,625,1466,1623,2552
2018/3/22,臺指選擇權,PUT,外資及陸資,65344,202193,60873,259858,4471,-57665,128003,463694,77195,357735,50808,105959
2018/3/23,臺指選擇權,CALL,自營商,141023,387258,157793,429914,-16770,-42655,91785,254695,115243,309507,-23458,-54812
2018/3/23,臺指選擇權,CALL,投信,0,0,0,0,0,0,0,0,682,1740,-682,-1740
2018/3/23,臺指選擇權,CALL,外資及陸資,67444,208595,57676,195318,9768,13276,82788,239758,44523,142843,38265,96915
2018/3/23,臺指選擇權,PUT,自營商,175761,802913,180607,903819,-4846,-100906,102947,715131,175022,1197479,-72075,-482348
2018/3/23,臺指選擇權,PUT,投信,0,0,448,1462,-448,-1462,1800,17910,625,4985,1175,12925
2018/3/23,臺指選擇權,PUT,外資及陸資,100390,578871,93999,436758,6391,142114,142323,1049195,85124,643875,57199,405320
2018/3/26,臺指選擇權,CALL,自營商,115467,277141,122467,282379,-7000,-5238,96313,346184,126771,419704,-30458,-73520
2018/3/26,臺指選擇權,CALL,投信,0,0,0,0,0,0,0,0,682,1997,-682,-1997
2018/3/26,臺指選擇權,CALL,外資及陸資,45349,158216,42835,148332,2514,9883,86225,291067,45446,172308,40779,118759
2018/3/26,臺指選擇權,PUT,自營商,175491,520774,157648,511013,17843,9762,124508,537130,178740,890184,-54232,-353054
2018/3/26,臺指選擇權,PUT,投信,224,75,0,0,224,75,2024,8419,625,2517,1399,5902
2018/3/26,臺指選擇權,PUT,外資及陸資,69061,258006,59101,222844,9960,35162,148281,816766,81122,477716,67159,339050
2018/3/27,臺指選擇權,CALL,自營商,164164,532191,152334,416261,11830,115930,103612,567379,122240,525764,-18628,41615
2018/3/27,臺指選擇權,CALL,投信,0,0,0,0,0,0,0,0,682,2878,-682,-2878
2018/3/27,臺指選擇權,CALL,外資及陸資,56076,184139,53523,197028,2553,-12889,90316,397538,46984,256258,43332,141280
2018/3/27,臺指選擇權,PUT,自營商,203806,333905,214667,330731,-10861,3174,130824,361162,195917,618589,-65093,-257427
2018/3/27,臺指選擇權,PUT,投信,112,29,0,0,112,29,2136,1000,625,1066,1511,-66
2018/3/27,臺指選擇權,PUT,外資及陸資,71643,191155,57822,154397,13821,36757,162489,602160,81509,331262,80980,270898
2018/3/28,臺指選擇權,CALL,自營商,184289,323917,204426,335700,-20137,-11783,70090,280856,80434,305410,-10344,-24554
2018/3/28,臺指選擇權,CALL,投信,0,0,0,0,0,0,0,0,682,1884,-682,-1884
2018/3/28,臺指選擇權,CALL,外資及陸資,59434,148787,55888,148306,3546,481,78537,278130,46330,170386,32207,107744
2018/3/28,臺指選擇權,PUT,自營商,214133,493201,224226,495738,-10093,-2537,92755,532632,160715,907821,-67960,-375189
2018/3/28,臺指選擇權,PUT,投信,400,29,496,1042,-96,-1013,0,0,609,2982,-609,-2982
2018/3/28,臺指選擇權,PUT,外資及陸資,83153,247091,78064,258115,5089,-11024,158632,947272,86779,569220,71853,378052
2018/3/29,臺指選擇權,CALL,自營商,98555,262605,98676,271889,-121,-9284,81776,321885,92241,357449,-10465,-35564
2018/3/29,臺指選擇權,CALL,投信,0,0,0,0,0,0,0,0,682,1920,-682,-1920
2018/3/29,臺指選擇權,CALL,外資及陸資,32237,115806,31876,121602,361,-5796,80639,286707,48071,182180,32568,104527
2018/3/29,臺指選擇權,PUT,自營商,100161,333174,96781,352806,3380,-19632,111805,546680,176385,915758,-64580,-369078
2018/3/29,臺指選擇權,PUT,投信,0,0,0,0,0,0,0,0,609,2370,-609,-2370
2018/3/29,臺指選擇權,PUT,外資及陸資,51420,204166,36163,163878,15257,40288,175443,945077,88333,550199,87110,394878
2018/3/30,臺指選擇權,CALL,自營商,90229,244531,80698,192821,9531,51710,92531,389986,93465,379172,-934,10814
2018/3/30,臺指選擇權,CALL,投信,0,0,0,0,0,0,0,0,682,2052,-682,-2052
2018/3/30,臺指選擇權,CALL,外資及陸資,32100,116329,24222,94549,7878,21780,89547,336389,49101,203540,40446,132849
2018/3/30,臺指選擇權,PUT,自營商,101442,266537,116585,321751,-15143,-55214,110995,427715,190718,774202,-79723,-346487
2018/3/30,臺指選擇權,PUT,投信,0,0,0,0,0,0,0,0,609,1362,-609,-1362
2018/3/30,臺指選擇權,PUT,外資及陸資,41266,132623,30953,109426,10313,23196,187159,763049,89736,435279,97423,327770
2018/3/31,臺指選擇權,CALL,自營商,58565,68713,58461,81929,104,-13216,98550,392808,99380,392635,-830,173
2018/3/31,臺指選擇權,CALL,投信,0,0,0,0,0,0,0,0,682,2039,-682,-2039
2018/3/31,臺指選擇權,CALL,外資及陸資,4181,13559,3498,12990,683,569,90396,337877,49267,204641,41129,133236
2018/3/31,臺指選擇權,PUT,自營商,41286,116061,37097,116834,4189,-773,116188,444621,191722,780101,-75534,-335480
2018/3/31,臺指選擇權,PUT,投信,950,4691,0,0,950,4691,950,4845,609,1251,341,3594
2018/3/31,臺指選擇權,PUT,外資及陸資,4939,13817,4042,13015,897,802,188110,736272,89790,420809,98320,315463
2018/4/2,臺指選擇權,CALL,自營商,76155,166751,75854,175402,301,-8651,104418,320317,104947,337708,-529,-17391
2018/4/2,臺指選擇權,CALL,投信,0,0,0,0,0,0,0,0,682,1650,-682,-1650
2018/4/2,臺指選擇權,CALL,外資及陸資,27504,84634,25695,86011,1809,-1377,94429,285181,51491,173731,42938,111450
2018/4/2,臺指選擇權,PUT,自營商,84877,254494,80585,222039,4292,32456,122570,517222,193812,854391,-71242,-337169
2018/4/2,臺指選擇權,PUT,投信,950,4438,0,0,950,4438,1900,10070,609,1559,1291,8511
2018/4/2,臺指選擇權,PUT,外資及陸資,34212,121719,32272,124928,1940,-3208,192757,833369,92497,486345,100260,347024
2018/4/3,臺指選擇權,CALL,自營商,100000,219585,112623,212965,-12623,6620,105412,277378,118564,290556,-13152,-13178
2018/4/3,臺指選擇權,CALL,投信,597,184,0,0,597,184,0,0,85,1139,-85,-1139
2018/4/3,臺指選擇權,CALL,外資及陸資,40371,116313,44832,143455,-4461,-27142,91963,221925,53486,157412,38477,64513
2018/4/3,臺指選擇權,PUT,自營商,124198,406203,113016,359753,11182,46450,130483,617861,190543,950959,-60060,-333098
2018/4/3,臺指選擇權,PUT,投信,0,0,0,0,0,0,1900,12588,609,2005,1291,10583
2018/4/3,臺指選擇權,PUT,外資及陸資,68097,251245,65703,272157,2394,-20912,200586,961632,97932,585133,102654,376499
2018/4/9,臺指選擇權,CALL,自營商,188176,339997,192432,323403,-4256,16595,78967,309977,93005,305514,-14038,4463
2018/4/9,臺指選擇權,CALL,投信,0,0,0,0,0,0,0,0,85,1441,-85,-1441
2018/4/9,臺指選擇權,CALL,外資及陸資,54878,148540,52463,145962,2415,2578,79056,250128,52969,191816,26087,58312
2018/4/9,臺指選擇權,PUT,自營商,214717,350176,243417,358227,-28700,-8051,110838,391491,175289,638847,-64451,-247356
2018/4/9,臺指選擇權,PUT,投信,384,4,373,722,11,-718,1900,5890,598,1384,1302,4506
2018/4/9,臺指選擇權,PUT,外資及陸資,78437,175165,70432,192694,8005,-17529,182952,633040,99768,404644,83184,228396
2018/4/10,臺指選擇權,CALL,自營商,158114,345164,151122,336703,6992,8461,96216,354350,103262,336980,-7046,17370
2018/4/10,臺指選擇權,CALL,投信,0,0,0,0,0,0,0,0,85,1568,-85,-1568
2018/4/10,臺指選擇權,CALL,外資及陸資,54171,157281,48567,154129,5604,3151,85200,275224,53509,211052,31691,64172
2018/4/10,臺指選擇權,PUT,自營商,197285,368330,204303,372850,-7018,-4520,126810,356023,198279,574213,-71469,-218190
2018/4/10,臺指選擇權,PUT,投信,0,0,0,0,0,0,1900,3800,598,849,1302,2951
2018/4/10,臺指選擇權,PUT,外資及陸資,64243,148129,51478,148362,12765,-233,197442,547616,101493,349560,95949,198056
2018/4/11,臺指選擇權,CALL,自營商,172138,305330,175584,330650,-3446,-25320,79036,333881,94315,342531,-15279,-8650
2018/4/11,臺指選擇權,CALL,投信,0,0,0,0,0,0,0,0,85,1653,-85,-1653
2018/4/11,臺指選擇權,CALL,外資及陸資,57442,206757,50904,153793,6538,52963,92983,299283,56767,189071,36216,110212
2018/4/11,臺指選擇權,PUT,自營商,207353,293653,227232,294839,-19879,-1187,109405,318498,181644,494589,-72239,-176091
2018/4/11,臺指選擇權,PUT,投信,0,0,1900,2442,-1900,-2442,0,0,598,450,-598,-450
2018/4/11,臺指選擇權,PUT,外資及陸資,83549,166974,57807,159923,25742,7051,217284,522324,102097,339050,115187,183274
2018/4/12,臺指選擇權,CALL,自營商,85776,184374,105248,241071,-19472,-56696,69491,255539,104242,307375,-34751,-51836
2018/4/12,臺指選擇權,CALL,投信,0,0,0,0,0,0,0,0,85,1492,-85,-1492
2018/4/12,臺指選擇權,CALL,外資及陸資,35351,112696,33802,109481,1549,3214,93887,254258,56122,149469,37765,104789
2018/4/12,臺指選擇權,PUT,自營商,116347,250307,117706,225090,-1359,25218,125455,371391,199053,519570,-73598,-148179
2018/4/12,臺指選擇權,PUT,投信,0,0,0,0,0,0,0,0,598,394,-598,-394
2018/4/12,臺指選擇權,PUT,外資及陸資,59639,137697,38498,129209,21141,8488,235308,542622,98980,348970,136328,193652
2018/4/13,臺指選擇權,CALL,自營商,87459,164645,86952,180546,507,-15901,73541,256497,107785,321607,-34244,-65110
2018/4/13,臺指選擇權,CALL,投信,0,0,0,0,0,0,0,0,85,1543,-85,-1543
2018/4/13,臺指選擇權,CALL,外資及陸資,32437,84512,27490,82686,4947,1826,98243,249800,55531,145943,42712,103857
2018/4/13,臺指選擇權,PUT,自營商,91330,163629,108158,189972,-16828,-26343,122897,318436,213323,486777,-90426,-168341
2018/4/13,臺指選擇權,PUT,投信,0,0,0,0,0,0,0,0,598,255,-598,-255
2018/4/13,臺指選擇權,PUT,外資及陸資,37360,84728,30372,97014,6988,-12286,243856,493408,100540,324073,143316,169335
2018/4/16,臺指選擇權,CALL,自營商,94244,158743,104163,180407,-9919,-21663,72732,233783,116895,308735,-44163,-74952
2018/4/16,臺指選擇權,CALL,投信,0,0,0,0,0,0,0,0,85,1458,-85,-1458
2018/4/16,臺指選擇權,CALL,外資及陸資,27185,78153,31549,85077,-4364,-6924,98859,226177,60511,134081,38348,92096
2018/4/16,臺指選擇權,PUT,自營商,101875,179613,97298,163827,4577,15786,131585,331751,217434,482350,-85849,-150599
2018/4/16,臺指選擇權,PUT,投信,187,29,173,792,14,-763,0,0,584,936,-584,-936
2018/4/16,臺指選擇權,PUT,外資及陸資,38722,99545,38291,110781,431,-11236,244765,479718,101018,328533,143747,151185
2018/4/17,臺指選擇權,CALL,自營商,164760,220926,189692,226855,-24932,-5929,76854,153990,145949,178141,-69095,-24151
2018/4/17,臺指選擇權,CALL,投信,421,1666,85,1013,336,653,336,655,85,927,251,-272
2018/4/17,臺指選擇權,CALL,外資及陸資,46865,93727,42113,110136,4752,-16408,99871,140940,56771,72881,43100,68059
2018/4/17,臺指選擇權,PUT,自營商,172086,356680,178288,391265,-6202,-34585,123754,471846,215805,631624,-92051,-159778
2018/4/17,臺指選擇權,PUT,投信,0,0,0,0,0,0,0,0,584,1427,-584,-1427
2018/4/17,臺指選擇權,PUT,外資及陸資,65950,262215,63559,231195,2391,31021,248876,627494,102738,427332,146138,200162
2018/4/18,臺指選擇權,CALL,自營商,297185,380656,310332,341743,-13147,38912,40317,114920,54211,142324,-13894,-27404
2018/4/18,臺指選擇權,CALL,投信,0,0,336,890,-336,-890,0,0,85,1054,-85,-1054
2018/4/18,臺指選擇權,CALL,外資及陸資,56178,162908,52932,160531,3246,2376,55520,138444,24794,65314,30726,73130
2018/4/18,臺指選擇權,PUT,自營商,267485,431490,300407,447919,-32922,-16429,64714,249951,101420,350835,-36706,-100884
2018/4/18,臺指選擇權,PUT,投信,2311,6568,407,516,1904,6052,1900,5130,580,1235,1320,3895
2018/4/18,臺指選擇權,PUT,外資及陸資,67945,215595,61520,215755,6425,-160,74900,332043,56778,291671,18122,40372
2018/4/19,臺指選擇權,CALL,自營商,104257,279172,93733,226787,10524,52385,56721,230259,60091,190883,-3370,39376
2018/4/19,臺指選擇權,CALL,投信,0,0,360,813,-360,-813,0,0,445,2218,-445,-2218
2018/4/19,臺指選擇權,CALL,外資及陸資,36358,126099,35130,144028,1228,-17929,62151,182925,30197,116171,31954,66754
2018/4/19,臺指選擇權,PUT,自營商,118496,245454,134856,279393,-16360,-33939,71626,196464,124692,284489,-53066,-88025
2018/4/19,臺指選擇權,PUT,投信,192,31,0,0,192,31,2092,1647,580,613,1512,1034
2018/4/19,臺指選擇權,PUT,外資及陸資,35703,112053,40413,149406,-4710,-37353,77606,258415,64194,253103,13412,5312
2018/4/20,臺指選擇權,CALL,自營商,125311,272273,148272,306033,-22961,-33760,68332,163137,94663,172843,-26331,-9706
2018/4/20,臺指選擇權,CALL,投信,0,0,182,354,-182,-354,0,0,627,1564,-627,-1564
2018/4/20,臺指選擇權,CALL,外資及陸資,43149,126396,44287,145231,-1138,-18835,65835,122178,35019,86768,30816,35410
2018/4/20,臺指選擇權,PUT,自營商,168279,509658,156225,448558,12054,61100,99676,424767,140688,500002,-41012,-75235
2018/4/20,臺指選擇權,PUT,投信,0,0,192,92,-192,-92,1900,6650,580,1374,1320,5276
2018/4/20,臺指選擇權,PUT,外資及陸資,59226,221117,54273,203452,4953,17665,84066,384362,65701,386376,18365,-2014
2018/4/23,臺指選擇權,CALL,自營商,166233,290621,188886,302694,-22653,-12073,73544,146344,122528,163742,-48984,-17398
2018/4/23,臺指選擇權,CALL,投信,0,0,0,0,0,0,0,0,627,978,-627,-978
2018/4/23,臺指選擇權,CALL,外資及陸資,42846,123768,47356,136689,-4510,-12921,63896,89994,37590,66671,26306,23323
2018/4/23,臺指選擇權,PUT,自營商,177649,554580,176453,500692,1196,53889,105613,558953,145429,584506,-39816,-25553
2018/4/23,臺指選擇權,PUT,投信,0,0,0,0,0,0,1900,11020,580,1859,1320,9161
2018/4/23,臺指選擇權,PUT,外資及陸資,63403,221149,61025,217707,2378,3442,88894,460689,68151,471616,20743,-10927
